year,fips,state_name,race,num_students,num_students_pub,num_exams,num_exams_pub,num_pass_exams,num_fail_exams,num_pass_exams_pub,num_fail_exams_pub,pct_pass_exams,pct_pass_exams_pub,num_grad_ap,num_grad_pass_ap,ap_mandate,ap_funding
2001,1,Alabama,Asian,266,216,500,404,365,135,292,112,.73000002,.7227723,,,0,0
2001,1,Alabama,Black,675,644,854,811,214,640,191,620,.25058547,.23551172,,,0,0
2001,1,Alabama,Hispanic,26,21,44,34,25,19,20,14,.56818181,.58823532,,,0,0
2001,1,Alabama,Total,5728,4345,8779,6465,5141,3638,3634,2831,.58560199,.56210363,2897,1552,0,0
2001,1,Alabama,White,4531,3292,6988,4931,4290,2698,2961,1970,.61390954,.6004867,,,0,0
2001,2,Alaska,Asian,123,121,235,233,110,125,110,123,.46808511,.472103,,,0,0
2001,2,Alaska,Black,34,32,45,42,20,25,19,23,.44444445,.45238096,,,0,0
2001,2,Alaska,Hispanic,25,19,51,43,32,19,27,16,.627451,.62790698,,,0,0
2001,2,Alaska,Total,1665,1572,2783,2674,1775,1008,1717,957,.63780093,.64210922,1042,664,0,0
2001,2,Alaska,White,1299,1232,2145,2068,1426,719,1382,686,.66480184,.66827852,,,0,0
2001,4,Arizona,Asian,609,510,1184,983,731,453,609,374,.61739862,.61953205,,,0,0
2001,4,Arizona,Black,129,110,194,169,83,111,73,96,.42783505,.43195266,,,0,0
2001,4,Arizona,Hispanic,773,656,1108,934,612,496,511,423,.55234659,.54710919,,,0,0
2001,4,Arizona,Total,8480,6932,14049,11399,8603,5446,7016,4383,.61235672,.61549258,4717,3102,0,0
2001,4,Arizona,White,6137,4969,10233,8232,6441,3792,5235,2997,.62943417,.63593292,,,0,0
2001,5,Arkansas,Asian,163,152,307,289,157,150,154,135,.51140064,.53287196,,,0,0
2001,5,Arkansas,Black,246,242,356,350,87,269,85,265,.24438202,.24285714,,,0,0
2001,5,Arkansas,Hispanic,43,37,74,60,35,39,26,34,.47297296,.43333334,,,0,0
2001,5,Arkansas,Total,4142,3663,6648,5897,3323,3325,2936,2961,.49984959,.49788028,2336,1187,0,0
2001,5,Arkansas,White,3482,3048,5576,4905,2853,2723,2505,2400,.51165712,.51070338,,,0,0
2001,6,California,Asian,36456,32383,72971,64868,43079,29892,37884,26984,.59035784,.5840168,,,0,0
2001,6,California,Black,4225,3608,6936,5865,2282,4654,1720,4145,.32900807,.29326513,,,0,0
2001,6,California,Hispanic,24851,22674,37435,34144,19941,17494,17846,16298,.53268331,.52266872,,,0,0
2001,6,California,Total,146922,125337,259901,220321,156685,103216,129101,91220,.60286415,.58596772,71898,50018,0,0
2001,6,California,White,58263,47369,103664,83392,68151,35513,53266,30126,.65742207,.63874233,,,0,0
2001,8,Colorado,Asian,749,678,1296,1186,793,503,724,462,.61188269,.61045533,,,0,0
2001,8,Colorado,Black,253,230,359,324,130,229,108,216,.36211699,.33333334,,,0,0
2001,8,Colorado,Hispanic,609,567,861,796,442,419,404,392,.51335657,.50753766,,,0,0
2001,8,Colorado,Total,12974,11391,20426,17839,12985,7441,11249,6590,.6357094,.63058466,7937,5217,0,0
2001,8,Colorado,White,10323,9031,16359,14245,10711,5648,9287,4958,.65474665,.65194803,,,0,0
2001,9,Connecticut,Asian,938,616,1852,1159,1374,478,831,328,.74190062,.71699739,,,0,0
2001,9,Connecticut,Black,524,394,770,556,277,493,153,403,.35974026,.27517986,,,0,0
2001,9,Connecticut,Hispanic,276,234,376,310,232,144,181,129,.61702126,.58387095,,,0,0
2001,9,Connecticut,Total,13832,9981,23356,16049,16804,6552,11279,4770,.71947253,.70278519,6252,4496,0,0
2001,9,Connecticut,White,10738,7826,18082,12587,13297,4785,9142,3445,.73537219,.72630489,,,0,0
2001,10,Delaware,Asian,221,145,481,312,359,122,214,98,.74636173,.68589741,,,0,0
2001,10,Delaware,Black,123,91,182,137,73,109,47,90,.40109891,.34306568,,,0,0
2001,10,Delaware,Hispanic,28,18,47,30,32,15,15,15,.68085104,.5,,,0,0
2001,10,Delaware,Total,2387,1346,4130,2261,2775,1355,1329,932,.67191285,.58779299,877,536,0,0
2001,10,Delaware,White,1863,1007,3140,1625,2124,1016,958,667,.67643315,.58953846,,,0,0
2001,11,District Of Columbia,Asian,131,54,263,105,162,101,30,75,.6159696,.2857143,,,0,0
2001,11,District Of Columbia,Black,551,338,890,533,232,658,125,408,.26067415,.23452158,,,0,0
2001,11,District Of Columbia,Hispanic,22,5,45,8,36,9,2,6,.80000001,.25,,,0,0
2001,11,District Of Columbia,Total,2211,696,4256,1258,2924,1332,532,726,.68703008,.42289349,467,190,0,0
2001,11,District Of Columbia,White,1052,131,2216,356,1853,363,234,122,.83619136,.65730339,,,0,0
2001,12,Florida,Asian,3275,2892,6938,6114,3912,3026,3291,2823,.56385124,.5382728,,,0,0
2001,12,Florida,Black,3817,3609,5964,5631,1814,4150,1649,3982,.30415827,.29284319,,,0,0
2001,12,Florida,Hispanic,1605,1386,2490,2146,1394,1096,1163,983,.55983937,.54193848,,,0,0
2001,12,Florida,Total,50430,42599,88348,74642,48953,39395,39671,34971,.55409288,.53148359,24536,14995,0,0
2001,12,Florida,White,30528,25663,54352,45651,31168,23184,25364,20287,.57344717,.55560666,,,0,0
2001,13,Georgia,Asian,1771,1578,3651,3241,2269,1382,1945,1296,.62147355,.60012341,,,0,0
2001,13,Georgia,Black,3454,3311,5052,4816,1204,3848,1056,3760,.23832145,.2192691,,,0,0
2001,13,Georgia,Hispanic,191,173,284,256,153,131,134,122,.53873241,.5234375,,,0,0
2001,13,Georgia,Total,22737,18792,37092,30219,20846,16246,15776,14443,.56200796,.52205569,12332,6754,0,0
2001,13,Georgia,White,15964,12598,25783,20016,15831,9952,11588,8428,.6140092,.57893687,,,0,0
2001,15,Hawaii,Asian,2266,1056,3840,1587,2442,1398,782,805,.63593751,.49275362,,,0,0
2001,15,Hawaii,Black,29,21,35,23,22,13,13,10,.62857145,.56521738,,,0,0
2001,15,Hawaii,Hispanic,35,19,58,33,40,18,23,10,.68965518,.69696969,,,0,0
2001,15,Hawaii,Total,3292,1506,5514,2251,3595,1919,1175,1076,.65197676,.52199024,1150,629,0,0
2001,15,Hawaii,White,638,286,1060,440,754,306,269,171,.71132076,.61136365,,,0,0
2001,16,Idaho,Asian,85,76,162,149,109,53,101,48,.67283952,.67785233,,,0,0
2001,16,Idaho,Black,5,4,7,6,4,3,4,2,.5714286,.66666669,,,0,0
2001,16,Idaho,Hispanic,41,40,49,48,24,25,23,25,.48979592,.47916666,,,0,0
2001,16,Idaho,Total,2531,2262,3740,3387,2346,1394,2153,1234,.62727273,.63566577,1632,1059,0,0
2001,16,Idaho,White,2256,2011,3286,2970,2054,1232,1886,1084,.62507606,.63501686,,,0,0
2001,17,Illinois,Asian,4124,3677,8409,7639,6183,2226,5682,1957,.73528361,.74381465,,,0,0
2001,17,Illinois,Black,1733,1358,2461,1942,753,1708,565,1377,.30597317,.29093719,,,0,0
2001,17,Illinois,Hispanic,1926,1471,2662,2064,1382,1280,1035,1029,.51915854,.50145346,,,0,0
2001,17,Illinois,Total,32690,26729,56503,46959,39983,16520,33618,13341,.70762616,.71590108,16565,12151,0,0
2001,17,Illinois,White,22692,18471,39277,32363,29117,10160,24291,8072,.74132442,.75057936,,,0,0
2001,18,Indiana,Asian,475,394,948,779,636,312,506,273,.6708861,.64955068,,,0,0
2001,18,Indiana,Black,367,342,514,474,116,398,88,386,.22568093,.18565401,,,0,0
2001,18,Indiana,Hispanic,183,152,259,222,94,165,79,143,.36293435,.35585585,,,0,0
2001,18,Indiana,Total,10704,9256,16352,13885,8678,7674,7043,6842,.53069961,.50723803,7426,3705,0,0
2001,18,Indiana,White,9238,8008,13926,11853,7402,6524,6047,5806,.53152376,.51016623,,,0,0
2001,19,Iowa,Asian,229,216,380,363,252,128,242,121,.66315788,.66666669,,,0,0
2001,19,Iowa,Black,23,21,38,36,17,21,15,21,.44736841,.41666666,,,0,0
2001,19,Iowa,Hispanic,23,19,38,30,26,12,20,10,.68421054,.66666669,,,0,0
2001,19,Iowa,Total,4069,3599,5995,5334,4033,1962,3633,1701,.67272729,.68110234,2435,1689,0,0
2001,19,Iowa,White,3586,3154,5232,4625,3528,1704,3162,1463,.67431194,.68367565,,,0,0
2001,20,Kansas,Asian,228,199,406,364,290,116,268,96,.71428573,.73626375,,,0,0
2001,20,Kansas,Black,157,154,176,173,29,147,28,145,.16477273,.16184971,,,0,0
2001,20,Kansas,Hispanic,71,63,88,80,46,42,42,38,.52272725,.52499998,,,0,0
2001,20,Kansas,Total,3666,3208,5204,4607,3490,1714,3108,1499,.67063797,.67462558,2340,1493,0,0
2001,20,Kansas,White,2984,2591,4208,3696,2904,1304,2565,1131,.69011408,.69399351,,,0,0
2001,21,Kentucky,Asian,274,224,543,423,358,185,275,148,.65930021,.65011823,,,0,0
2001,21,Kentucky,Black,165,150,232,209,66,166,55,154,.28448275,.2631579,,,0,0
2001,21,Kentucky,Hispanic,44,35,62,50,34,28,24,26,.54838711,.47999999,,,0,0
2001,21,Kentucky,Total,8028,6424,12853,10049,6421,6432,4686,5363,.4995721,.46631506,4266,2210,0,0
2001,21,Kentucky,White,7246,5771,11524,8972,5699,5825,4123,4849,.49453315,.45954078,,,0,0
2001,22,Louisiana,Asian,257,177,444,305,307,137,207,98,.69144142,.67868853,,,0,0
2001,22,Louisiana,Black,410,300,544,382,159,385,118,264,.29227942,.30890054,,,0,0
2001,22,Louisiana,Hispanic,33,17,45,18,28,17,8,10,.62222224,.44444445,,,0,0
2001,22,Louisiana,Total,3672,1840,5531,2606,3538,1993,1490,1116,.63966733,.5717575,1296,726,0,0
2001,22,Louisiana,White,2728,1233,4126,1755,2781,1345,1059,696,.67401844,.60341883,,,0,0
2001,23,Maine,Asian,97,63,140,95,77,63,55,40,.55000001,.57894737,,,0,0
2001,23,Maine,Black,17,15,23,21,10,13,9,12,.43478259,.42857143,,,0,0
2001,23,Maine,Hispanic,13,8,16,10,6,10,4,6,.375,.40000001,,,0,0
2001,23,Maine,Total,3830,3060,5466,4283,3479,1987,2691,1592,.63648003,.62829792,2050,1371,0,0
2001,23,Maine,White,3498,2802,4970,3899,3191,1779,2467,1432,.64205229,.63272631,,,0,0
2001,24,Maryland,Asian,2372,2099,4788,4246,3516,1272,3151,1095,.73433584,.74211019,,,0,0
2001,24,Maryland,Black,2090,1798,2966,2544,1092,1874,867,1677,.36817262,.34080189,,,0,0
2001,24,Maryland,Hispanic,170,126,266,186,183,83,132,54,.68796992,.7096774,,,0,0
2001,24,Maryland,Total,21923,17333,37368,29536,25739,11629,20215,9321,.68879789,.68441904,10613,7309,0,0
2001,24,Maryland,White,15186,11707,25736,19897,18422,7314,14257,5640,.71580666,.71654016,,,0,0
2001,25,Massachusetts,Asian,2038,1413,3946,2701,2850,1096,1868,833,.7222504,.69159573,,,0,0
2001,25,Massachusetts,Black,634,444,966,657,480,486,262,395,.49689442,.39878234,,,0,0
2001,25,Massachusetts,Hispanic,208,158,318,224,225,93,154,70,.70754719,.6875,,,0,0
2001,25,Massachusetts,Total,23234,16671,38790,27158,27637,11153,18708,8450,.71247745,.68885779,11072,7956,0,0
2001,25,Massachusetts,White,18323,13301,30180,21424,21639,8541,14951,6473,.71699804,.69786221,,,0,0
2001,26,Michigan,Asian,1628,1401,3231,2777,2336,895,2001,776,.722996,.72056174,,,0,0
2001,26,Michigan,Black,850,727,1212,1041,458,754,379,662,.37788779,.36407301,,,0,0
2001,26,Michigan,Hispanic,258,204,358,290,182,176,152,138,.50837988,.52413791,,,0,0
2001,26,Michigan,Total,23079,19511,36335,30673,23325,13010,19438,11235,.64194304,.63371694,13569,8620,0,0
2001,26,Michigan,White,18720,15830,28874,24394,18621,10253,15540,8854,.64490545,.63704187,,,0,0
2001,27,Minnesota,Asian,922,801,1535,1332,827,708,699,633,.53876221,.52477479,,,0,0
2001,27,Minnesota,Black,175,144,253,203,97,156,62,141,.38339922,.30541873,,,0,0
2001,27,Minnesota,Hispanic,88,76,125,107,57,68,50,57,.456,.46728972,,,0,0
2001,27,Minnesota,Total,14839,12741,23015,19680,13286,9729,11220,8460,.57727569,.57012194,8374,4848,0,0
2001,27,Minnesota,White,12866,11059,19889,17025,11607,8282,9834,7191,.5835889,.57762116,,,0,0
2001,28,Mississippi,Asian,95,58,168,78,97,71,30,48,.57738096,.38461539,,,0,0
2001,28,Mississippi,Black,451,427,593,564,94,499,87,477,.15851602,.15425532,,,0,0
2001,28,Mississippi,Hispanic,12,10,16,14,7,9,6,8,.4375,.42857143,,,0,0
2001,28,Mississippi,Total,2918,2112,4121,2879,1768,2353,1078,1801,.42902207,.37443557,1626,630,0,0
2001,28,Mississippi,White,2235,1530,3173,2104,1508,1665,923,1181,.47526002,.43868822,,,0,0
2001,29,Missouri,Asian,374,281,794,598,598,196,450,148,.75314862,.75250834,,,0,0
2001,29,Missouri,Black,242,162,336,211,143,193,99,112,.42559522,.46919432,,,0,0
2001,29,Missouri,Hispanic,55,36,84,54,56,28,34,20,.66666669,.62962961,,,0,0
2001,29,Missouri,Total,7034,4730,11757,7622,8107,3650,5002,2620,.68954664,.65625823,3463,2208,0,0
2001,29,Missouri,White,6009,4009,9913,6332,6867,3046,4129,2203,.69272673,.65208465,,,0,0
2001,30,Montana,Asian,33,31,48,46,30,18,30,16,.625,.65217394,,,0,0
2001,30,Montana,Black,7,6,8,7,2,6,1,6,.25,.14285715,,,0,0
2001,30,Montana,Hispanic,14,13,23,22,18,5,17,5,.78260869,.77272725,,,0,0
2001,30,Montana,Total,1688,1597,2368,2245,1543,825,1458,787,.65160471,.64944321,1216,757,0,0
2001,30,Montana,White,1546,1461,2167,2052,1429,738,1349,703,.659437,.6574074,,,0,0
2001,31,Nebraska,Asian,70,56,111,87,66,45,52,35,.5945946,.59770113,,,0,0
2001,31,Nebraska,Black,27,25,35,31,10,25,8,23,.2857143,.25806451,,,0,0
2001,31,Nebraska,Hispanic,13,12,17,14,6,11,4,10,.35294119,.2857143,,,0,0
2001,31,Nebraska,Total,1786,1420,2545,2028,1593,952,1244,784,.62593323,.6134122,1097,684,0,0
2001,31,Nebraska,White,1598,1262,2259,1795,1432,827,1115,680,.63390881,.62116992,,,0,0
2001,32,Nevada,Asian,402,355,812,707,457,355,384,323,.56280786,.54314005,,,0,0
2001,32,Nevada,Black,72,66,117,106,54,63,52,54,.46153846,.49056605,,,0,0
2001,32,Nevada,Hispanic,173,154,249,223,142,107,125,98,.57028115,.56053811,,,0,0
2001,32,Nevada,Total,3369,2909,6056,5156,3468,2588,2914,2242,.5726552,.56516677,1994,1270,0,0
2001,32,Nevada,White,2393,2055,4283,3619,2464,1819,2063,1556,.57529771,.57004696,,,0,0
2001,33,New Hampshire,Asian,196,70,354,115,264,90,68,47,.74576271,.59130436,,,0,0
2001,33,New Hampshire,Black,31,9,52,17,30,22,8,9,.57692307,.47058824,,,0,0
2001,33,New Hampshire,Hispanic,16,7,26,8,17,9,3,5,.65384614,.375,,,0,0
2001,33,New Hampshire,Total,3506,2290,5205,3208,3556,1649,2002,1206,.68318921,.62406486,1868,1251,0,0
2001,33,New Hampshire,White,3034,2102,4431,2932,2990,1441,1831,1101,.67479122,.62448841,,,0,0
2001,34,New Jersey,Asian,4343,3692,8676,7345,6366,2310,5458,1887,.73374826,.74309051,,,0,0
2001,34,New Jersey,Black,972,765,1443,1131,560,883,400,731,.38808039,.35366932,,,0,0
2001,34,New Jersey,Hispanic,440,357,644,523,345,299,278,245,.53571427,.53154874,,,0,0
2001,34,New Jersey,Total,26930,21224,47031,36895,32814,14217,25941,10954,.69771004,.70310342,14141,10146,0,0
2001,34,New Jersey,White,18026,14003,31183,24076,22158,9025,17277,6799,.71057945,.71760261,,,0,0
2001,35,New Mexico,Asian,135,108,234,185,131,103,95,90,.55982906,.51351351,,,0,0
2001,35,New Mexico,Black,47,43,74,69,16,58,14,55,.21621622,.20289855,,,0,0
2001,35,New Mexico,Hispanic,668,607,954,855,404,550,332,523,.42348009,.38830408,,,0,0
2001,35,New Mexico,Total,3996,3442,6216,5331,2953,3263,2320,3011,.47506434,.43519041,2288,1178,0,0
2001,35,New Mexico,White,2161,1877,3506,3043,1857,1649,1488,1555,.52966344,.48899114,,,0,0
2001,36,New York,Asian,8952,8025,16863,15230,11295,5568,10256,4974,.66980964,.67340773,,,0,0
2001,36,New York,Black,4560,3774,6504,5405,2142,4362,1669,3736,.32933578,.30878815,,,0,0
2001,36,New York,Hispanic,1912,1438,2655,2009,1322,1333,1014,995,.49792844,.50472873,,,0,0
2001,36,New York,Total,78856,65514,131438,110142,83087,48351,69631,40511,.63213837,.63219297,39758,26520,0,0
2001,36,New York,White,52160,43213,88031,73540,57676,30355,48322,25218,.65517831,.65708458,,,0,0
2001,37,North Carolina,Asian,1120,952,2381,2048,1386,995,1122,926,.58210838,.54785156,,,0,0
2001,37,North Carolina,Black,2108,1997,3239,3078,875,2364,791,2287,.27014512,.25698507,,,0,0
2001,37,North Carolina,Hispanic,164,145,269,232,142,127,113,119,.52788103,.48706895,,,0,0
2001,37,North Carolina,Total,24044,20980,41880,36245,23601,18279,19578,16667,.56353867,.54015726,13209,7967,0,0
2001,37,North Carolina,White,19472,16884,33900,29126,20018,13882,16627,12499,.59050149,.5708645,,,0,0
2001,38,North Dakota,Asian,18,18,28,28,21,7,21,7,.75,.75,,,0,0
2001,38,North Dakota,Black,1,1,1,1,0,1,0,1,0,0,,,0,0
2001,38,North Dakota,Hispanic,2,2,2,2,1,1,1,1,.5,.5,,,0,0
2001,38,North Dakota,Total,773,768,1093,1083,738,355,730,353,.67520583,.67405355,558,402,0,0
2001,38,North Dakota,White,737,732,1041,1031,703,338,695,336,.67531222,.67410278,,,0,0
2001,39,Ohio,Asian,1291,971,2583,1908,1892,691,1365,543,.7324816,.7154088,,,0,0
2001,39,Ohio,Black,1063,838,1500,1155,475,1025,346,809,.31666666,.2995671,,,0,0
2001,39,Ohio,Hispanic,139,117,191,158,103,88,79,79,.539267,.5,,,0,0
2001,39,Ohio,Total,25335,19169,39558,29493,25610,13948,18590,10903,.64740384,.63031906,12923,8063,0,0
2001,39,Ohio,White,21575,16330,33234,24829,21840,11394,15936,8893,.65715832,.64183015,,,0,0
2001,40,Oklahoma,Asian,445,380,856,706,504,352,382,324,.58878505,.54107648,,,0,0
2001,40,Oklahoma,Black,314,299,482,455,162,320,147,308,.33609959,.32307693,,,0,0
2001,40,Oklahoma,Hispanic,172,162,259,239,119,140,105,134,.45945945,.43933055,,,0,0
2001,40,Oklahoma,Total,7619,6607,12037,10326,6311,5726,5240,5086,.5243001,.5074569,4219,2316,0,0
2001,40,Oklahoma,White,5699,4917,8921,7629,4828,4093,4018,3611,.54119492,.52667451,,,0,0
2001,41,Oregon,Asian,453,400,728,626,473,255,404,222,.64972526,.64536738,,,0,0
2001,41,Oregon,Black,55,47,67,55,22,45,16,39,.3283582,.29090908,,,0,0
2001,41,Oregon,Hispanic,102,88,140,115,79,61,67,48,.5642857,.5826087,,,0,0
2001,41,Oregon,Total,5784,4954,8326,6977,5429,2897,4527,2450,.65205383,.64884621,3479,2259,0,0
2001,41,Oregon,White,4760,4069,6770,5656,4424,2346,3677,1979,.65347117,.65010607,,,0,0
2001,42,Pennsylvania,Asian,1801,1377,3413,2621,2443,970,1904,717,.71579254,.72644031,,,0,0
2001,42,Pennsylvania,Black,715,504,1013,735,385,628,270,465,.38005924,.36734694,,,0,0
2001,42,Pennsylvania,Hispanic,186,143,270,205,163,107,129,76,.60370368,.62926829,,,0,0
2001,42,Pennsylvania,Total,28581,21495,45924,34126,30519,15405,22647,11479,.66455448,.66362888,15010,10093,0,0
2001,42,Pennsylvania,White,24145,18249,38429,28605,25587,12842,18982,9623,.66582531,.66359025,,,0,0
2001,44,Rhode Island,Asian,120,77,208,115,125,83,56,59,.60096157,.48695651,,,0,0
2001,44,Rhode Island,Black,48,30,69,40,33,36,17,23,.47826087,.42500001,,,0,0
2001,44,Rhode Island,Hispanic,11,7,15,7,8,7,3,4,.53333336,.42857143,,,0,0
2001,44,Rhode Island,Total,2349,1337,3699,1896,2355,1344,1081,815,.63665855,.57014769,903,530,0,0
2001,44,Rhode Island,White,1953,1106,3079,1582,1979,1100,919,663,.64274114,.58091027,,,0,0
2001,45,South Carolina,Asian,423,387,862,805,521,341,488,317,.60440832,.60621119,,,1,1
2001,45,South Carolina,Black,1409,1384,2029,1997,537,1492,519,1478,.26466238,.25988984,,,1,1
2001,45,South Carolina,Hispanic,72,66,114,104,62,52,59,45,.54385966,.56730771,,,1,1
2001,45,South Carolina,Total,10470,9349,16888,15073,9588,7300,8376,6697,.56774038,.55569559,6064,3554,1,1
2001,45,South Carolina,White,8129,7111,13134,11486,8049,5085,6946,4540,.6128369,.60473621,,,1,1
2001,46,South Dakota,Asian,35,33,54,50,31,23,27,23,.57407409,.54000002,,,0,0
2001,46,South Dakota,Black,4,4,4,4,2,2,2,2,.5,.5,,,0,0
2001,46,South Dakota,Hispanic,6,4,10,6,6,4,3,3,.60000002,.5,,,0,0
2001,46,South Dakota,Total,1410,1343,2102,1996,1149,953,1084,912,.54662228,.54308617,958,557,0,0
2001,46,South Dakota,White,1309,1248,1961,1865,1081,880,1023,842,.55124938,.54852545,,,0,0
2001,47,Tennessee,Asian,508,377,982,716,659,323,460,256,.67107946,.64245808,,,0,0
2001,47,Tennessee,Black,1046,929,1437,1284,438,999,372,912,.30480167,.28971961,,,0,0
2001,47,Tennessee,Hispanic,49,40,71,60,41,30,38,22,.57746476,.63333333,,,0,0
2001,47,Tennessee,Total,9883,6961,15710,10800,10212,5498,6540,4260,.65003181,.60555553,4806,2838,0,0
2001,47,Tennessee,White,7836,5313,12475,8253,8554,3921,5358,2895,.68569136,.64921844,,,0,0
2001,48,Texas,Asian,6013,5305,14038,12328,8746,5292,7479,4849,.62302321,.60666776,,,0,0
2001,48,Texas,Black,3421,3194,5637,5244,1484,4153,1290,3954,.2632606,.24599542,,,0,0
2001,48,Texas,Hispanic,14338,13723,22796,21834,8648,14148,8125,13709,.37936479,.37212604,,,0,0
2001,48,Texas,Total,69569,62884,125785,113161,64157,61628,55389,57772,.51005286,.48947075,39456,22576,0,0
2001,48,Texas,White,37835,33428,69907,61680,38669,31238,32814,28866,.55314916,.53200388,,,0,0
2001,49,Utah,Asian,451,418,859,803,521,338,485,318,.60651922,.60398507,,,0,0
2001,49,Utah,Black,24,20,35,26,17,18,12,14,.48571429,.46153846,,,0,0
2001,49,Utah,Hispanic,155,138,232,203,144,88,126,77,.62068963,.62068963,,,0,0
2001,49,Utah,Total,12269,11558,20044,18849,13242,6802,12509,6340,.66064656,.66364264,7507,5231,0,0
2001,49,Utah,White,10949,10355,17801,16803,11848,5953,11242,5561,.66558057,.66904718,,,0,0
2001,50,Vermont,Asian,53,45,84,73,59,25,49,24,.70238096,.67123288,,,0,0
2001,50,Vermont,Black,7,5,11,9,8,3,6,3,.72727275,.66666669,,,0,0
2001,50,Vermont,Hispanic,7,4,9,5,5,4,3,2,.55555558,.60000002,,,0,0
2001,50,Vermont,Total,1903,1598,2809,2310,1947,862,1536,774,.69312924,.66493505,1176,817,0,0
2001,50,Vermont,White,1735,1464,2557,2108,1766,791,1396,712,.69065309,.66223907,,,0,0
2001,51,Virginia,Asian,3176,2963,6418,5992,3771,2647,3492,2500,.5875662,.58277702,,,0,0
2001,51,Virginia,Black,2269,2164,3494,3315,1242,2252,1138,2177,.35546651,.34328809,,,0,0
2001,51,Virginia,Hispanic,371,353,613,583,365,248,344,239,.59543228,.59005147,,,0,0
2001,51,Virginia,Total,31598,28026,56144,49461,34379,21765,29656,19805,.61233616,.59958351,17150,10900,0,0
2001,51,Virginia,White,22962,20109,40713,35347,26019,14694,22176,13171,.63908333,.62737995,,,0,0
2001,53,Washington,Asian,1868,1658,3094,2752,1754,1340,1521,1231,.56690371,.55268896,,,0,0
2001,53,Washington,Black,243,215,338,296,130,208,101,195,.38461539,.34121621,,,0,0
2001,53,Washington,Hispanic,298,273,396,357,214,182,191,166,.54040402,.53501403,,,0,0
2001,53,Washington,Total,13399,11447,20352,17365,13160,7192,11008,6357,.6466195,.63391882,7531,5002,0,0
2001,53,Washington,White,9795,8337,14693,12485,9861,4832,8265,4220,.6711359,.6619944,,,0,0
2001,54,West Virginia,Asian,116,102,269,237,198,71,177,60,.73605949,.74683547,,,0,0
2001,54,West Virginia,Black,38,35,42,38,9,33,8,30,.21428572,.21052632,,,0,0
2001,54,West Virginia,Hispanic,5,4,10,9,8,2,7,2,.80000001,.77777779,,,0,0
2001,54,West Virginia,Total,2504,2329,3784,3494,1972,1812,1808,1686,.52114165,.5174585,1688,896,0,0
2001,54,West Virginia,White,2246,2098,3298,3061,1657,1641,1528,1533,.50242573,.49918327,,,0,0
2001,55,Wisconsin,Asian,541,466,926,776,607,319,496,280,.65550756,.63917524,,,0,0
2001,55,Wisconsin,Black,218,190,309,267,105,204,79,188,.33980581,.29588014,,,0,0
2001,55,Wisconsin,Hispanic,187,162,256,224,120,136,98,126,.46875,.4375,,,0,0
2001,55,Wisconsin,Total,15504,13736,23729,20815,15698,8031,13538,7277,.66155338,.65039635,9597,6403,0,0
2001,55,Wisconsin,White,13986,12440,21364,18825,14291,7073,12405,6420,.66892904,.65896416,,,0,0
2001,56,Wyoming,Asian,33,33,44,44,23,21,23,21,.52272725,.52272725,,,0,0
2001,56,Wyoming,Black,0,0,0,0,0,0,0,0,,,,,0,0
2001,56,Wyoming,Hispanic,17,17,25,25,12,13,12,13,.47999999,.47999999,,,0,0
2001,56,Wyoming,Total,738,735,1111,1108,613,498,611,497,.55175519,.55144405,579,340,0,0
2001,56,Wyoming,White,639,636,963,960,529,434,527,433,.54932505,.54895836,,,0,0
2002,1,Alabama,Asian,303,253,596,486,428,168,354,132,.71812081,.72839504,,,0,0
2002,1,Alabama,Black,666,630,871,821,221,650,194,627,.25373134,.23629721,,,0,0
2002,1,Alabama,Hispanic,41,36,66,60,35,31,32,28,.530303,.53333336,,,0,0
2002,1,Alabama,Total,6199,4753,9727,7364,5691,4036,4170,3194,.58507246,.56626832,3103,1710,0,0
2002,1,Alabama,White,4923,3639,7764,5684,4743,3021,3404,2280,.61089647,.59887403,,,0,0
2002,2,Alaska,Asian,115,115,215,215,125,90,125,90,.58139533,.58139533,,,0,0
2002,2,Alaska,Black,25,25,35,35,14,21,14,21,.40000001,.40000001,,,0,0
2002,2,Alaska,Hispanic,18,15,26,23,16,10,14,9,.61538464,.60869563,,,0,0
2002,2,Alaska,Total,1688,1615,2996,2898,2098,898,2042,856,.70026702,.70462388,1085,762,0,0
2002,2,Alaska,White,1370,1310,2460,2377,1777,683,1730,647,.72235775,.72780818,,,0,0
2002,4,Arizona,Asian,737,647,1400,1227,871,529,749,478,.62214285,.61043197,,,0,0
2002,4,Arizona,Black,146,119,215,170,91,124,72,98,.4232558,.42352942,,,0,0
2002,4,Arizona,Hispanic,909,769,1359,1125,743,616,606,519,.54672551,.53866667,,,0,0
2002,4,Arizona,Total,9766,8189,16202,13462,9957,6245,8140,5322,.61455375,.60466498,5100,3285,0,0
2002,4,Arizona,White,6987,5822,11719,9674,7436,4283,6034,3640,.63452512,.6237337,,,0,0
2002,5,Arkansas,Asian,223,206,456,419,270,186,254,165,.59210527,.60620522,,,0,0
2002,5,Arkansas,Black,281,277,447,442,84,363,81,361,.18791947,.18325792,,,0,0
2002,5,Arkansas,Hispanic,41,36,60,53,36,24,35,18,.60000002,.66037738,,,0,0
2002,5,Arkansas,Total,4602,4137,7584,6817,3801,3783,3404,3413,.50118673,.49933988,2630,1333,0,0
2002,5,Arkansas,White,3818,3401,6205,5521,3174,3031,2816,2705,.51152295,.5100525,,,0,0
2002,6,California,Asian,39882,35515,80727,72066,48652,32075,42771,29295,.60267323,.59349763,,,0,0
2002,6,California,Black,4806,4135,7983,6845,2793,5190,2125,4720,.34986848,.31044558,,,0,0
2002,6,California,Hispanic,28515,26296,43616,40302,22566,21050,20439,19863,.51737893,.50714606,,,0,0
2002,6,California,Total,163581,140310,291945,249149,177593,114352,146552,102597,.60830981,.58821028,78638,53816,0,0
2002,6,California,White,64643,52693,116254,93887,77912,38342,60793,33094,.67018771,.64751244,,,0,0
2002,8,Colorado,Asian,846,793,1452,1361,917,535,846,515,.63154268,.62160176,,,0,0
2002,8,Colorado,Black,260,240,384,351,152,232,136,215,.39583334,.38746437,,,0,0
2002,8,Colorado,Hispanic,651,618,877,832,428,449,407,425,.48802736,.48918268,,,0,0
2002,8,Colorado,Total,14457,13299,22760,20896,15064,7696,13703,7193,.66186291,.65577143,8585,5582,0,0
2002,8,Colorado,White,11542,10607,18300,16812,12469,5831,11380,5432,.68136615,.67689747,,,0,0
2002,9,Connecticut,Asian,986,661,1931,1240,1436,495,882,358,.74365616,.7112903,,,0,0
2002,9,Connecticut,Black,595,469,864,665,325,539,214,451,.3761574,.32180452,,,0,0
2002,9,Connecticut,Hispanic,314,266,417,349,243,174,197,152,.58273381,.56446993,,,0,0
2002,9,Connecticut,Total,15078,11025,25710,18000,18900,6810,13001,4999,.7351225,.72227776,6790,5006,0,0
2002,9,Connecticut,White,11756,8665,20116,14244,15166,4950,10652,3592,.75392723,.74782366,,,0,0
2002,10,Delaware,Asian,247,179,559,408,419,140,296,112,.74955279,.72549021,,,0,0
2002,10,Delaware,Black,128,106,197,159,94,103,61,98,.47715735,.3836478,,,0,0
2002,10,Delaware,Hispanic,24,15,34,19,24,10,12,7,.70588237,.63157892,,,0,0
2002,10,Delaware,Total,2655,1533,4730,2719,3254,1476,1680,1039,.68794924,.61787421,1017,617,0,0
2002,10,Delaware,White,2079,1141,3635,1977,2502,1133,1214,763,.68830812,.61406171,,,0,0
2002,11,District Of Columbia,Asian,150,51,316,97,210,106,30,67,.66455698,.30927834,,,0,0
2002,11,District Of Columbia,Black,651,429,1044,721,285,759,156,565,.2729885,.21636616,,,0,0
2002,11,District Of Columbia,Hispanic,18,3,44,6,39,5,5,1,.88636363,.83333331,,,0,0
2002,11,District Of Columbia,Total,2412,777,4607,1412,3113,1494,547,865,.67571086,.38739377,584,234,0,0
2002,11,District Of Columbia,White,1135,126,2355,305,1971,384,218,87,.83694267,.7147541,,,0,0
2002,12,Florida,Asian,3645,3259,7683,6807,4475,3208,3856,2951,.58245474,.56647569,,,0,0
2002,12,Florida,Black,4641,4467,7305,7009,2362,4943,2216,4793,.32334018,.31616494,,,0,0
2002,12,Florida,Hispanic,1932,1739,2993,2660,1649,1344,1414,1246,.5509522,.53157896,,,0,0
2002,12,Florida,Total,59076,51222,104061,89447,58123,45938,48155,41292,.55854738,.53836352,28170,17256,0,0
2002,12,Florida,White,35377,30509,63430,54190,36665,26765,30322,23868,.57803881,.55954975,,,0,0
2002,13,Georgia,Asian,2100,1894,4284,3823,2687,1597,2344,1479,.62721753,.61313105,,,0,0
2002,13,Georgia,Black,3893,3695,5697,5406,1516,4181,1339,4067,.26610497,.24768776,,,0,0
2002,13,Georgia,Hispanic,252,226,376,339,212,164,187,152,.56382978,.55162239,,,0,0
2002,13,Georgia,Total,25944,21704,42748,35444,25297,17451,19856,15588,.59177035,.56020766,13518,7686,0,0
2002,13,Georgia,White,18127,14571,29781,23744,19227,10554,14710,9034,.64561296,.61952496,,,0,0
2002,15,Hawaii,Asian,2518,1170,4169,1710,2814,1355,918,792,.67498201,.53684211,,,0,0
2002,15,Hawaii,Black,43,33,66,50,29,37,15,35,.43939394,.30000001,,,0,0
2002,15,Hawaii,Hispanic,34,17,56,24,30,26,10,14,.53571427,.41666666,,,0,0
2002,15,Hawaii,Total,3777,1754,6225,2550,4227,1998,1347,1203,.67903614,.52823532,1239,682,0,0
2002,15,Hawaii,White,743,352,1244,523,885,359,301,222,.71141481,.57552582,,,0,0
2002,16,Idaho,Asian,70,66,113,109,86,27,84,25,.76106197,.77064222,,,0,0
2002,16,Idaho,Black,7,7,17,17,13,4,13,4,.7647059,.7647059,,,0,0
2002,16,Idaho,Hispanic,42,42,73,73,35,38,35,38,.47945204,.47945204,,,0,0
2002,16,Idaho,Total,2500,2384,3821,3646,2571,1250,2437,1209,.6728605,.66840374,1795,1156,0,0
2002,16,Idaho,White,2203,2101,3338,3182,2252,1086,2133,1049,.6746555,.67033315,,,0,0
2002,17,Illinois,Asian,4327,3945,8980,8259,6760,2220,6248,2011,.75278395,.75650805,,,0,0
2002,17,Illinois,Black,2336,2029,3344,2917,970,2374,785,2132,.29007176,.26911211,,,0,0
2002,17,Illinois,Hispanic,2265,1887,3245,2673,1663,1582,1331,1342,.51248074,.49794239,,,0,0
2002,17,Illinois,Total,36863,30723,63612,53424,45910,17702,38720,14704,.72171915,.72476792,18833,13666,0,0
2002,17,Illinois,White,25474,20845,43929,36209,33641,10288,27993,8216,.76580393,.77309507,,,0,0
2002,18,Indiana,Asian,489,411,1034,843,712,322,558,285,.68858802,.66192168,,,0,0
2002,18,Indiana,Black,370,339,509,458,134,375,98,360,.26326129,.21397381,,,0,0
2002,18,Indiana,Hispanic,166,143,245,215,101,144,83,132,.41224489,.3860465,,,0,0
2002,18,Indiana,Total,11425,9935,17914,15166,10338,7576,8374,6792,.57709056,.55215615,7575,4134,0,0
2002,18,Indiana,White,9883,8628,15244,12979,8848,6396,7241,5738,.58042508,.5579012,,,0,0
2002,19,Iowa,Asian,226,215,383,369,286,97,278,91,.74673629,.75338751,,,0,0
2002,19,Iowa,Black,26,26,41,41,23,18,23,18,.56097561,.56097561,,,0,0
2002,19,Iowa,Hispanic,35,32,39,36,21,18,21,15,.53846157,.58333331,,,0,0
2002,19,Iowa,Total,4499,3981,6565,5866,4592,1973,4147,1719,.69946688,.70695531,2667,1828,0,0
2002,19,Iowa,White,3983,3502,5738,5089,3991,1747,3577,1512,.69553852,.70288861,,,0,0
2002,20,Kansas,Asian,237,218,416,393,302,114,284,109,.72596157,.7226463,,,0,0
2002,20,Kansas,Black,104,98,134,127,32,102,32,95,.23880596,.2519685,,,0,0
2002,20,Kansas,Hispanic,69,65,81,76,52,29,48,28,.64197528,.63157892,,,0,0
2002,20,Kansas,Total,3940,3580,5693,5191,3927,1766,3610,1581,.68979448,.69543439,2458,1631,0,0
2002,20,Kansas,White,3321,3020,4772,4345,3349,1423,3080,1265,.70180219,.70886075,,,0,0
2002,21,Kentucky,Asian,315,274,593,495,386,207,321,174,.65092748,.64848483,,,0,0
2002,21,Kentucky,Black,217,198,323,294,101,222,88,206,.31269351,.29931971,,,0,0
2002,21,Kentucky,Hispanic,39,34,59,49,26,33,19,30,.44067797,.3877551,,,0,0
2002,21,Kentucky,Total,8925,7317,14224,11456,7233,6991,5444,6012,.50850677,.4752095,4537,2396,0,0
2002,21,Kentucky,White,8030,6551,12682,10162,6392,6290,4757,5405,.50402147,.46811652,,,0,0
2002,22,Louisiana,Asian,281,182,511,323,355,156,209,114,.69471622,.64705884,,,0,0
2002,22,Louisiana,Black,400,316,518,400,155,363,112,288,.2992278,.28,,,0,0
2002,22,Louisiana,Hispanic,26,14,49,23,35,14,14,9,.71428573,.60869563,,,0,0
2002,22,Louisiana,Total,3951,1961,5854,2777,3771,2083,1553,1224,.64417493,.55923659,1399,775,0,0
2002,22,Louisiana,White,2972,1311,4379,1843,2954,1425,1093,750,.67458326,.59305483,,,0,0
2002,23,Maine,Asian,102,63,168,114,97,71,72,42,.57738096,.63157892,,,0,0
2002,23,Maine,Black,12,12,19,19,13,6,13,6,.68421054,.68421054,,,0,0
2002,23,Maine,Hispanic,7,6,9,8,5,4,5,3,.55555558,.625,,,0,0
2002,23,Maine,Total,4086,3275,6050,4772,3904,2146,3095,1677,.64528924,.64857501,2572,1701,0,0
2002,23,Maine,White,3751,3032,5528,4385,3586,1942,2851,1534,.64869756,.65017104,,,0,0
2002,24,Maryland,Asian,2819,2487,6033,5371,4458,1575,3970,1401,.73893583,.7391547,,,0,0
2002,24,Maryland,Black,2370,2019,3493,2979,1431,2062,1150,1829,.40967649,.38603559,,,0,0
2002,24,Maryland,Hispanic,212,165,373,289,250,123,200,89,.6702413,.69204152,,,0,0
2002,24,Maryland,Total,24985,20091,45013,36338,32046,12967,25688,10650,.71192765,.70691836,12019,8414,0,0
2002,24,Maryland,White,17125,13457,30745,24260,22832,7913,17977,6283,.74262482,.741014,,,0,0
2002,25,Massachusetts,Asian,2370,1695,4548,3212,3355,1193,2286,926,.73768687,.7117061,,,0,0
2002,25,Massachusetts,Black,690,499,1037,718,474,563,260,458,.45708776,.36211699,,,0,0
2002,25,Massachusetts,Hispanic,189,152,262,206,184,78,138,68,.70229006,.66990292,,,0,0
2002,25,Massachusetts,Total,25238,18458,41930,30021,30830,11100,21401,8620,.73527306,.71286768,12084,8773,0,0
2002,25,Massachusetts,White,19730,14574,32392,23420,24103,8289,16984,6436,.74410349,.72519213,,,0,0
2002,26,Michigan,Asian,1788,1524,3619,3096,2707,912,2287,809,.74799669,.73869509,,,0,0
2002,26,Michigan,Black,958,837,1401,1219,564,837,444,775,.40256959,.36423299,,,0,0
2002,26,Michigan,Hispanic,258,215,383,317,207,176,175,142,.54046994,.55205047,,,0,0
2002,26,Michigan,Total,25303,21438,39636,33370,26311,13325,21892,11478,.66381574,.65603834,14706,9594,0,0
2002,26,Michigan,White,20672,17498,31629,26556,21109,10520,17558,8998,.66739386,.66116887,,,0,0
2002,27,Minnesota,Asian,1035.6,898,1726,1538,1019,707,894,644,.5903824,.58127439,,,0,0
2002,27,Minnesota,Black,188.37,202,273,218,110,163,80,138,.40293041,.36697248,,,0,0
2002,27,Minnesota,Hispanic,101.32,202,149,124,79,70,68,56,.53020132,.54838711,,,0,0
2002,27,Minnesota,Total,16011,13907,24578,21302,15698,8880,13497,7805,.63870126,.6336025,8926,5631,0,0
2002,27,Minnesota,White,13553.92,12049,21178,18351,13714,7464,11802,6549,.64755881,.64312571,,,0,0
2002,28,Mississippi,Asian,93.22500000000001,68,165,81,104,61,38,43,.63030303,.46913579,,,0,0
2002,28,Mississippi,Black,465.12,2002,612,586,118,494,101,485,.19281046,.17235495,,,0,0
2002,28,Mississippi,Hispanic,17.76,0,24,21,15,9,13,8,.625,.61904764,,,0,0
2002,28,Mississippi,Total,3036.6,2224,4338,3007,2055,2283,1260,1747,.47372061,.41902229,1659,696,0,0
2002,28,Mississippi,White,2328.9,1706,3327,2167,1714,1613,1045,1122,.51517886,.48223349,,,0,0
2002,29,Missouri,Asian,518.105,315,917,716,733,184,572,144,.79934567,.79888266,,,0,0
2002,29,Missouri,Black,275.12,193,362,269,191,171,129,140,.52762431,.47955391,,,0,0
2002,29,Missouri,Hispanic,74.74000000000001,90,101,70,62,39,37,33,.61386138,.52857143,,,0,0
2002,29,Missouri,Total,9588.6,5826,13698,9394,9747,3951,6358,3036,.71156371,.67681497,3895,2566,0,0
2002,29,Missouri,White,8054.200000000001,4894,11506,7802,8210,3296,5293,2509,.71354073,.67841578,,,0,0
2002,30,Montana,Asian,49,49,82,82,62,20,62,20,.75609756,.75609756,,,0,0
2002,30,Montana,Black,3,3,3,3,1,2,1,2,.33333334,.33333334,,,0,0
2002,30,Montana,Hispanic,15,14,24,23,13,11,13,10,.54166669,.56521738,,,0,0
2002,30,Montana,Total,1886,1793,2763,2651,1964,799,1891,760,.71082157,.71331573,1367,929,0,0
2002,30,Montana,White,1720,1633,2523,2418,1810,713,1739,679,.7173999,.71918941,,,0,0
2002,31,Nebraska,Asian,75,63,137,113,83,54,69,44,.60583943,.61061949,,,0,0
2002,31,Nebraska,Black,31,31,45,45,18,27,18,27,.40000001,.40000001,,,0,0
2002,31,Nebraska,Hispanic,32,26,48,40,28,20,22,18,.58333331,.55000001,,,0,0
2002,31,Nebraska,Total,1922,1551,2864,2326,1803,1061,1439,887,.62953913,.61865866,1199,733,0,0
2002,31,Nebraska,White,1687,1347,2497,2012,1588,909,1258,754,.63596314,.62524849,,,0,0
2002,32,Nevada,Asian,455,403,942,837,523,419,457,380,.55520171,.54599762,,,0,0
2002,32,Nevada,Black,111,104,163,154,63,100,58,96,.38650307,.37662336,,,0,0
2002,32,Nevada,Hispanic,206,198,347,335,179,168,176,159,.51585013,.52537316,,,0,0
2002,32,Nevada,Total,3786,3413,7023,6293,4137,2886,3659,2634,.58906448,.58143967,2239,1375,0,0
2002,32,Nevada,White,2605,2349,4827,4334,2943,1884,2618,1716,.60969543,.60406089,,,0,0
2002,33,New Hampshire,Asian,247,94,438,149,343,95,107,42,.78310502,.71812081,,,0,0
2002,33,New Hampshire,Black,46,6,64,12,41,23,9,3,.640625,.75,,,0,0
2002,33,New Hampshire,Hispanic,10,5,16,6,14,2,5,1,.875,.83333331,,,0,0
2002,33,New Hampshire,Total,3731,2446,5449,3450,3862,1587,2349,1101,.70875388,.68086958,1919,1341,0,0
2002,33,New Hampshire,White,3196,2222,4602,3120,3211,1391,2107,1013,.69774014,.67532051,,,0,0
2002,34,New Jersey,Asian,4726,4073,9537,8195,7204,2333,6284,1911,.75537384,.76680905,,,0,0
2002,34,New Jersey,Black,1105,852,1608,1227,686,922,475,752,.42661691,.38712308,,,0,0
2002,34,New Jersey,Hispanic,472,377,707,535,406,301,292,243,.57425743,.54579437,,,0,0
2002,34,New Jersey,Total,29197,23154,51365,40693,37042,14323,29558,11135,.72115254,.72636569,15350,11230,0,0
2002,34,New Jersey,White,19325,15061,33754,26296,24724,9030,19414,6882,.73247617,.73828721,,,0,0
2002,35,New Mexico,Asian,170,145,293,246,168,125,134,112,.57337886,.54471546,,,0,0
2002,35,New Mexico,Black,47,45,65,62,19,46,17,45,.2923077,.27419356,,,0,0
2002,35,New Mexico,Hispanic,760,708,1143,1059,413,730,352,707,.36132982,.33238906,,,0,0
2002,35,New Mexico,Total,4444,3911,7008,6171,3205,3803,2586,3585,.45733449,.41905689,2496,1215,0,0
2002,35,New Mexico,White,2290,1991,3795,3301,2025,1770,1629,1672,.53359681,.49348682,,,0,0
2002,36,New York,Asian,9581,8706,18124,16608,12327,5797,11323,5285,.68014789,.68177986,,,0,0
2002,36,New York,Black,4858,4201,6971,6000,2475,4496,1960,4040,.35504231,.32666665,,,0,0
2002,36,New York,Hispanic,2005,1549,2832,2213,1494,1338,1130,1083,.52754235,.51061904,,,0,0
2002,36,New York,Total,84536,71181,142083,120202,93596,48487,78677,41525,.65874171,.65453988,42000,28196,0,0
2002,36,New York,White,56312,47065,96015,80600,65868,30147,55163,25437,.68601781,.68440449,,,0,0
2002,37,North Carolina,Asian,1344,1171,2898,2520,1750,1148,1434,1086,.60386473,.56904763,,,0,0
2002,37,North Carolina,Black,2589,2503,4078,3950,1143,2935,1057,2893,.28028446,.26759493,,,0,0
2002,37,North Carolina,Hispanic,211,193,363,327,200,163,170,157,.55096418,.51987767,,,0,0
2002,37,North Carolina,Total,27790,24716,49375,43652,29228,20147,24821,18831,.59195948,.56861085,15008,9016,0,0
2002,37,North Carolina,White,22103,19488,39366,34530,24582,14784,20879,13651,.62444746,.6046626,,,0,0
2002,38,North Dakota,Asian,20,20,35,35,25,10,25,10,.71428573,.71428573,,,0,0
2002,38,North Dakota,Black,6,6,10,10,5,5,5,5,.5,.5,,,0,0
2002,38,North Dakota,Hispanic,4,4,4,4,3,1,3,1,.75,.75,,,0,0
2002,38,North Dakota,Total,906,885,1302,1278,902,400,882,396,.69278032,.69014084,562,402,0,0
2002,38,North Dakota,White,850,830,1223,1200,853,370,833,367,.69746524,.69416666,,,0,0
2002,39,Ohio,Asian,1402,1119,2893,2336,2275,618,1823,513,.78638095,.78039384,,,0,0
2002,39,Ohio,Black,1118,955,1546,1316,562,984,436,880,.36351874,.33130699,,,0,0
2002,39,Ohio,Hispanic,146,116,197,157,103,94,73,84,.52284265,.46496814,,,0,0
2002,39,Ohio,Total,28195,21832,44344,34088,29848,14496,22208,11880,.67310119,.65149027,14057,8896,0,0
2002,39,Ohio,White,24085,18536,37434,28576,25372,12062,18782,9794,.67777956,.65726483,,,0,0
2002,40,Oklahoma,Asian,478,418,967,846,554,413,465,381,.5729059,.54964536,,,0,0
2002,40,Oklahoma,Black,367,354,524,508,159,365,154,354,.30343512,.30314961,,,0,0
2002,40,Oklahoma,Hispanic,225,211,316,294,168,148,154,140,.5316456,.52380955,,,0,0
2002,40,Oklahoma,Total,8944,8083,14433,12940,7654,6779,6615,6325,.53031248,.51120555,5032,2620,0,0
2002,40,Oklahoma,White,6706,6031,10840,9665,5920,4920,5104,4561,.54612547,.52809107,,,0,0
2002,41,Oregon,Asian,584,518,908,806,600,308,518,288,.66079295,.64267993,,,0,0
2002,41,Oregon,Black,40,38,50,48,17,33,16,32,.34,.33333334,,,0,0
2002,41,Oregon,Hispanic,112,100,144,120,92,52,76,44,.6388889,.63333333,,,0,0
2002,41,Oregon,Total,6185,5370,8968,7683,6170,2798,5213,2470,.68800181,.67851102,3643,2477,0,0
2002,41,Oregon,White,5014,4346,7229,6181,5002,2227,4227,1954,.69193524,.6838699,,,0,0
2002,42,Pennsylvania,Asian,1926,1513,3691,2920,2742,949,2170,750,.74288809,.74315071,,,0,0
2002,42,Pennsylvania,Black,774,586,1115,833,409,706,285,548,.36681613,.34213686,,,0,0
2002,42,Pennsylvania,Hispanic,180,131,253,182,149,104,110,72,.58893281,.60439563,,,0,0
2002,42,Pennsylvania,Total,31053,23448,50477,37695,34815,15662,25998,11697,.68972009,.68969357,15890,10918,0,0
2002,42,Pennsylvania,White,26305,19927,42357,31668,29341,13016,21972,9696,.69270724,.6938234,,,0,0
2002,44,Rhode Island,Asian,150,99,281,174,195,86,112,62,.69395018,.64367819,,,0,0
2002,44,Rhode Island,Black,52,33,77,41,37,40,12,29,.48051947,.29268292,,,0,0
2002,44,Rhode Island,Hispanic,15,12,19,14,10,9,6,8,.52631581,.42857143,,,0,0
2002,44,Rhode Island,Total,2622,1558,4219,2332,2814,1405,1432,900,.66698271,.61406517,1118,666,0,0
2002,44,Rhode Island,White,2155,1265,3447,1884,2317,1130,1159,725,.67217869,.61518049,,,0,0
2002,45,South Carolina,Asian,434,399,889,826,620,269,574,252,.69741285,.69491524,,,1,1
2002,45,South Carolina,Black,1360,1338,1998,1968,649,1349,628,1340,.32482481,.31910568,,,1,1
2002,45,South Carolina,Hispanic,74,71,131,127,74,57,74,53,.5648855,.58267719,,,1,1
2002,45,South Carolina,Total,11323,10080,18750,16610,11317,7433,9799,6811,.60357332,.58994579,6444,3944,1,1
2002,45,South Carolina,White,8924,7805,14873,12944,9462,5411,8085,4859,.63618636,.6246137,,,1,1
2002,46,South Dakota,Asian,40,38,81,72,58,23,52,20,.71604937,.72222221,,,0,0
2002,46,South Dakota,Black,5,3,7,4,4,3,2,2,.5714286,.5,,,0,0
2002,46,South Dakota,Hispanic,6,6,10,10,6,4,6,4,.60000002,.60000002,,,0,0
2002,46,South Dakota,Total,1434,1353,2302,2148,1410,892,1315,833,.61251086,.6121974,1003,610,0,0
2002,46,South Dakota,White,1335,1263,2126,1997,1289,837,1209,788,.60630292,.60540813,,,0,0
2002,47,Tennessee,Asian,596,464,1171,901,822,349,616,285,.70196414,.68368477,,,0,0
2002,47,Tennessee,Black,1036,957,1456,1327,456,1000,377,950,.31318682,.28409946,,,0,0
2002,47,Tennessee,Hispanic,63,55,83,71,50,33,44,27,.60240966,.61971831,,,0,0
2002,47,Tennessee,Total,10884,7910,17433,12276,11731,5702,7733,4543,.67291915,.62992829,5193,3153,0,0
2002,47,Tennessee,White,8693,6101,13848,9409,9768,4080,6317,3092,.70537263,.67137849,,,0,0
2002,48,Texas,Asian,6862,6418,15990,15008,10451,5539,9700,5308,.65359598,.64632195,,,0,0
2002,48,Texas,Black,4076,3910,6513,6227,1828,4685,1685,4542,.28066942,.27059579,,,0,0
2002,48,Texas,Hispanic,16515,15837,26036,25003,10334,15702,9704,15299,.39691198,.38811344,,,0,0
2002,48,Texas,Total,80240,74148,144060,132802,76802,67258,68769,64033,.5331251,.51783103,43308,24801,0,0
2002,48,Texas,White,43556,39462,80266,72626,46721,33545,41144,31482,.58207709,.5665189,,,0,0
2002,49,Utah,Asian,482,449,908,846,617,291,579,267,.67951542,.68439716,,,0,0
2002,49,Utah,Black,34,30,46,38,24,22,19,19,.52173913,.5,,,0,0
2002,49,Utah,Hispanic,165,145,233,200,131,102,119,81,.56223178,.59500003,,,0,0
2002,49,Utah,Total,12937,12437,21251,20316,14660,6591,14060,6256,.68984991,.69206536,7744,5586,0,0
2002,49,Utah,White,11461,11066,18838,18092,13101,5737,12609,5483,.69545597,.69693786,,,0,0
2002,50,Vermont,Asian,56,36,87,57,67,20,44,13,.77011496,.7719298,,,0,0
2002,50,Vermont,Black,11,8,15,11,4,11,3,8,.26666668,.27272728,,,0,0
2002,50,Vermont,Hispanic,6,5,10,8,6,4,4,4,.60000002,.5,,,0,0
2002,50,Vermont,Total,2103,1786,3075,2547,2074,1001,1668,879,.67447156,.65488809,1280,910,0,0
2002,50,Vermont,White,1929,1658,2811,2356,1897,914,1545,811,.67484879,.65577251,,,0,0
2002,51,Virginia,Asian,3639,3371,7403,6874,4459,2944,4109,2765,.60232335,.59775966,,,0,0
2002,51,Virginia,Black,2559,2439,4043,3822,1506,2537,1367,2455,.37249568,.35766613,,,0,0
2002,51,Virginia,Hispanic,388,359,659,601,409,250,368,233,.62063736,.61231279,,,0,0
2002,51,Virginia,Total,34785,30881,62363,54955,39634,22729,34344,20611,.63553709,.62494767,17825,11198,0,0
2002,51,Virginia,White,24908,21796,44526,38583,29825,14701,25521,13062,.66983336,.66145712,,,0,0
2002,53,Washington,Asian,2278,2037,3910,3511,2395,1515,2125,1386,.61253196,.60524064,,,0,0
2002,53,Washington,Black,262,238,387,350,126,261,106,244,.3255814,.30285713,,,0,0
2002,53,Washington,Hispanic,399,380,546,519,279,267,265,254,.51098901,.51059729,,,0,0
2002,53,Washington,Total,15834,13750,24657,21408,16254,8403,13868,7540,.6592043,.6477952,8513,5619,0,0
2002,53,Washington,White,11511,9929,17696,15242,12082,5614,10259,4983,.68275315,.67307442,,,0,0
2002,54,West Virginia,Asian,111,99,224,206,152,72,140,66,.6785714,.67961162,,,0,0
2002,54,West Virginia,Black,35,34,52,51,13,39,13,38,.25,.25490198,,,0,0
2002,54,West Virginia,Hispanic,8,6,13,10,8,5,7,3,.61538464,.69999999,,,0,0
2002,54,West Virginia,Total,2781,2575,4184,3871,2040,2144,1854,2017,.48757172,.478946,1806,886,0,0
2002,54,West Virginia,White,2528,2359,3736,3482,1771,1965,1626,1856,.4740364,.46697301,,,0,0
2002,55,Wisconsin,Asian,606,528,1061,928,767,294,661,267,.72290289,.71228451,,,0,0
2002,55,Wisconsin,Black,212,186,288,246,108,180,81,165,.375,.32926831,,,0,0
2002,55,Wisconsin,Hispanic,221,191,302,263,166,136,140,123,.54966885,.53231937,,,0,0
2002,55,Wisconsin,Total,16670,14918,25785,22890,18130,7655,15926,6964,.70312196,.69576234,10205,7100,0,0
2002,55,Wisconsin,White,14974,13448,23089,20566,16356,6733,14436,6130,.70838928,.70193523,,,0,0
2002,56,Wyoming,Asian,20,20,30,30,19,11,19,11,.63333333,.63333333,,,0,0
2002,56,Wyoming,Black,4,4,8,8,2,6,2,6,.25,.25,,,0,0
2002,56,Wyoming,Hispanic,21,21,36,36,18,18,18,18,.5,.5,,,0,0
2002,56,Wyoming,Total,858,855,1245,1240,617,628,612,628,.49558234,.49354839,619,347,0,0
2002,56,Wyoming,White,772,769,1113,1108,551,562,546,562,.49505839,.49277979,,,0,0
2003,1,Alabama,Asian,349,289,688,574,491,197,406,168,.7136628,.70731705,,,0,0
2003,1,Alabama,Black,574,542,753,703,212,541,193,510,.28154051,.27453768,,,0,0
2003,1,Alabama,Hispanic,44,43,69,68,41,28,41,27,.59420288,.60294116,,,0,0
2003,1,Alabama,Total,6604,5036,10453,7889,6108,4345,4492,3397,.58432984,.56940043,3123,1723,0,0
2003,1,Alabama,White,5370,3967,8506,6226,5106,3400,3672,2554,.60028213,.5897848,,,0,0
2003,2,Alaska,Asian,159,157,280,277,135,145,133,144,.48214287,.48014441,,,0,0
2003,2,Alaska,Black,43,43,73,73,14,59,14,59,.19178082,.19178082,,,0,0
2003,2,Alaska,Hispanic,27,25,40,38,22,18,21,17,.55000001,.55263156,,,0,0
2003,2,Alaska,Total,1860,1779,3184,3080,1966,1218,1906,1174,.61746234,.61883116,1191,803,0,0
2003,2,Alaska,White,1429,1363,2476,2390,1621,855,1566,824,.65468496,.6552301,,,0,0
2003,4,Arizona,Asian,820,718,1553,1330,1004,549,845,485,.64649063,.63533837,,,0,0
2003,4,Arizona,Black,171,155,256,229,109,147,93,136,.42578125,.40611354,,,0,0
2003,4,Arizona,Hispanic,1033,898,1557,1310,816,741,665,645,.52408481,.50763357,,,0,0
2003,4,Arizona,Total,10699,9114,17892,14922,11102,6790,9037,5885,.6205008,.60561585,5719,3715,0,0
2003,4,Arizona,White,7551,6383,12773,10568,8192,4581,6631,3937,.64135283,.62746024,,,0,0
2003,5,Arkansas,Asian,212,198,440,411,240,200,219,192,.54545456,.53284669,,,0,0
2003,5,Arkansas,Black,333,326,537,528,111,426,107,421,.20670392,.20265152,,,0,0
2003,5,Arkansas,Hispanic,69,66,111,106,72,39,69,37,.64864862,.6509434,,,0,0
2003,5,Arkansas,Total,5251,4803,8590,7903,4120,4470,3722,4181,.47962746,.47096041,2955,1509,0,0
2003,5,Arkansas,White,4376,3966,7086,6459,3483,3603,3124,3335,.49153259,.48366621,,,0,0
2003,6,California,Asian,42891,38213,87422,77898,52014,35408,45675,32223,.59497607,.58634371,,,0,0
2003,6,California,Black,5334,4626,8792,7627,2937,5855,2295,5332,.3340537,.30090469,,,0,0
2003,6,California,Hispanic,31947,29440,49896,46068,24382,25514,22044,24024,.4886564,.47851002,,,0,0
2003,6,California,Total,176715,151759,317872,271805,188711,129161,156220,115585,.59366977,.5747503,86303,58907,0,0
2003,6,California,White,69153,56501,125657,101842,82785,42872,64987,36855,.65881723,.63811588,,,0,0
2003,8,Colorado,Asian,906,850,1627,1529,1006,621,931,598,.61831594,.60889471,,,0,0
2003,8,Colorado,Black,340,323,510,482,195,315,178,304,.38235295,.36929461,,,0,0
2003,8,Colorado,Hispanic,733,706,1072,1032,521,551,500,532,.48600745,.48449612,,,0,0
2003,8,Colorado,Total,16260,15073,26383,24437,16914,9469,15499,8938,.64109462,.63424313,9526,6220,0,0
2003,8,Colorado,White,12927,11930,21054,19434,13897,7157,12716,6718,.66006458,.6543172,,,0,0
2003,9,Connecticut,Asian,1064,689,2133,1372,1668,465,1046,326,.7819972,.76239067,,,0,0
2003,9,Connecticut,Black,668,535,1016,774,383,633,227,547,.3769685,.29328164,,,0,0
2003,9,Connecticut,Hispanic,363,307,505,423,267,238,210,213,.52871287,.49645391,,,0,0
2003,9,Connecticut,Total,16110,11813,27566,19336,20198,7368,13838,5498,.73271424,.71565992,7177,5238,0,0
2003,9,Connecticut,White,12551,9232,21474,15116,16126,5348,11202,3914,.75095463,.74106908,,,0,0
2003,10,Delaware,Asian,270,198,585,420,434,151,294,126,.74188036,.69999999,,,0,0
2003,10,Delaware,Black,142,121,221,184,89,132,62,122,.40271494,.33695653,,,0,0
2003,10,Delaware,Hispanic,33,26,47,33,29,18,18,15,.61702126,.54545456,,,0,0
2003,10,Delaware,Total,2941,1802,5123,3046,3371,1752,1704,1342,.65801287,.55942219,1201,690,0,0
2003,10,Delaware,White,2273,1331,3905,2194,2590,1315,1217,977,.66325223,.55469459,,,0,0
2003,11,District Of Columbia,Asian,151,49,325,85,222,103,26,59,.68307692,.30588236,,,0,0
2003,11,District Of Columbia,Black,664,477,1014,721,286,728,130,591,.2820513,.18030514,,,0,0
2003,11,District Of Columbia,Hispanic,21,6,38,6,29,9,2,4,.7631579,.33333334,,,0,0
2003,11,District Of Columbia,Total,2510,841,4798,1456,3203,1595,499,957,.66756982,.34271979,605,243,0,0
2003,11,District Of Columbia,White,1241,135,2659,349,2172,487,220,129,.81684846,.63037246,,,0,0
2003,12,Florida,Asian,4220,3809,8993,8089,4891,4102,4288,3801,.54386747,.53010261,,,0,1
2003,12,Florida,Black,5842,5621,9402,9011,2652,6750,2455,6556,.28206766,.27244478,,,0,1
2003,12,Florida,Hispanic,2355,2153,3764,3414,1833,1931,1592,1822,.48698193,.46631518,,,0,1
2003,12,Florida,Total,70182,61232,126367,109434,65789,60578,54436,54998,.5206185,.49743223,32566,19452,0,1
2003,12,Florida,White,41312,35796,75752,65126,41199,34553,34012,31114,.54386681,.52224916,,,0,1
2003,13,Georgia,Asian,2392,2167,4840,4369,2991,1849,2636,1733,.61797523,.6033417,,,0,0
2003,13,Georgia,Black,3950,3760,5956,5661,1658,4298,1474,4187,.27837476,.26037803,,,0,0
2003,13,Georgia,Hispanic,311,290,450,411,247,203,222,189,.54888886,.54014599,,,0,0
2003,13,Georgia,Total,27870,23419,46458,38718,27168,19290,21354,17364,.58478624,.55152643,14274,8141,0,0
2003,13,Georgia,White,19486,15727,32403,25907,20590,11813,15678,10229,.63543499,.60516465,,,0,0
2003,15,Hawaii,Asian,2619,1327,4300,1959,2670,1630,913,1046,.62093025,.46605411,,,0,0
2003,15,Hawaii,Black,36,28,55,40,27,28,14,26,.4909091,.34999999,,,0,0
2003,15,Hawaii,Hispanic,50,28,78,38,37,41,11,27,.47435898,.28947368,,,0,0
2003,15,Hawaii,Total,3922,1955,6426,2888,4066,2360,1392,1496,.63274199,.48199445,1306,675,0,0
2003,15,Hawaii,White,742,385,1215,577,838,377,329,248,.68971193,.57019067,,,0,0
2003,16,Idaho,Asian,95,91,156,149,101,55,97,52,.6474359,.6510067,,,0,0
2003,16,Idaho,Black,10,9,16,15,11,5,10,5,.6875,.66666669,,,0,0
2003,16,Idaho,Hispanic,47,45,68,64,32,36,31,33,.47058824,.484375,,,0,0
2003,16,Idaho,Total,2768,2660,4298,4143,2771,1527,2656,1487,.64471847,.64108133,1836,1188,0,0
2003,16,Idaho,White,2452,2359,3776,3652,2431,1345,2340,1312,.64380294,.64074481,,,0,0
2003,17,Illinois,Asian,4575,4175,9487,8738,7126,2361,6596,2142,.75113314,.7548638,,,0,0
2003,17,Illinois,Black,2269,1954,3327,2846,1108,2219,895,1951,.33303276,.31447646,,,0,0
2003,17,Illinois,Hispanic,2586,2069,3721,2971,1907,1814,1457,1514,.51249665,.49040726,,,0,0
2003,17,Illinois,Total,39592,33128,69529,58646,50254,19275,42674,15972,.72277755,.72765404,20968,15237,0,0
2003,17,Illinois,White,27563,22798,48666,40526,37180,11486,31308,9218,.76398307,.77254111,,,0,0
2003,18,Indiana,Asian,608,511,1202,1015,809,393,670,345,.67304492,.66009849,,,0,0
2003,18,Indiana,Black,457,413,655,581,168,487,132,449,.25648856,.22719449,,,0,0
2003,18,Indiana,Hispanic,189,158,304,254,114,190,92,162,.375,.36220473,,,0,0
2003,18,Indiana,Total,13206,11512,20571,17661,11096,9475,9187,8474,.5394001,.52018571,8115,4352,0,0
2003,18,Indiana,White,11399,9977,17496,15084,9473,8023,7893,7191,.54143804,.52326971,,,0,0
2003,19,Iowa,Asian,239,223,445,415,329,116,310,105,.73932582,.74698794,,,0,0
2003,19,Iowa,Black,34,33,47,45,20,27,20,25,.42553192,.44444445,,,0,0
2003,19,Iowa,Hispanic,45,40,61,55,38,23,36,19,.62295079,.65454543,,,0,0
2003,19,Iowa,Total,5141,4535,7721,6822,5323,2398,4729,2093,.68941849,.6931985,2993,2041,0,0
2003,19,Iowa,White,4594,4032,6791,5962,4670,2121,4119,1843,.68767488,.69087553,,,0,0
2003,20,Kansas,Asian,289,268,519,478,368,151,343,135,.7090559,.71757323,,,0,0
2003,20,Kansas,Black,132,128,160,152,58,102,54,98,.36250001,.35526314,,,0,0
2003,20,Kansas,Hispanic,81,74,99,88,62,37,54,34,.62626261,.61363637,,,0,0
2003,20,Kansas,Total,4208,3797,6332,5714,4325,2007,3928,1786,.68303853,.68743438,2535,1727,0,0
2003,20,Kansas,White,3475,3117,5208,4682,3594,1614,3252,1430,.69009215,.69457495,,,0,0
2003,21,Kentucky,Asian,325,289,629,544,396,233,346,198,.62957072,.63602942,,,0,0
2003,21,Kentucky,Black,351,337,525,490,144,381,122,368,.2742857,.2489796,,,0,0
2003,21,Kentucky,Hispanic,54,49,86,77,38,48,35,42,.44186047,.45454547,,,0,0
2003,21,Kentucky,Total,10154,8397,16447,13256,8019,8428,5969,7287,.48756611,.45028666,5136,2639,0,0
2003,21,Kentucky,White,9028,7392,14532,11587,7084,7448,5189,6398,.4874759,.44782946,,,0,0
2003,22,Louisiana,Asian,304,210,558,364,408,150,257,107,.73118281,.70604396,,,0,0
2003,22,Louisiana,Black,370,278,503,363,192,311,132,231,.38170975,.36363637,,,0,0
2003,22,Louisiana,Hispanic,31,16,39,21,24,15,14,7,.61538464,.66666669,,,0,0
2003,22,Louisiana,Total,4129,2008,6166,2928,3882,2284,1677,1251,.62958157,.57274592,1542,807,0,0
2003,22,Louisiana,White,3134,1372,4630,1989,2950,1680,1147,842,.63714904,.57667172,,,0,0
2003,23,Maine,Asian,136,79,204,126,117,87,81,45,.57352942,.64285713,,,0,0
2003,23,Maine,Black,28,19,45,30,18,27,15,15,.40000001,.5,,,0,0
2003,23,Maine,Hispanic,11,8,17,10,14,3,7,3,.82352942,.69999999,,,0,0
2003,23,Maine,Total,4565,3677,6735,5328,4201,2534,3332,1996,.62375647,.62537539,2743,1746,0,0
2003,23,Maine,White,4125,3360,6042,4833,3782,2260,3010,1823,.62595165,.6228016,,,0,0
2003,24,Maryland,Asian,3520,3176,7373,6687,5269,2104,4789,1898,.71463448,.71616572,,,0,0
2003,24,Maryland,Black,3231,2859,4888,4314,1776,3112,1473,2841,.3633388,.34144646,,,0,0
2003,24,Maryland,Hispanic,293,235,467,374,277,190,221,153,.59314775,.59090906,,,0,0
2003,24,Maryland,Total,29993,24880,53363,44408,36124,17239,29691,14717,.67694843,.66859573,13315,9184,0,0
2003,24,Maryland,White,19887,16028,35208,28489,25182,10026,20228,8261,.71523517,.71002841,,,0,0
2003,25,Massachusetts,Asian,2622,1908,4998,3598,3764,1234,2667,931,.75310123,.74124515,,,0,0
2003,25,Massachusetts,Black,793,599,1173,855,513,660,305,550,.43734014,.35672516,,,0,0
2003,25,Massachusetts,Hispanic,259,213,375,305,234,141,181,124,.62400001,.59344262,,,0,0
2003,25,Massachusetts,Total,27494,20313,45823,33045,33273,12550,23243,9802,.72612005,.70337421,13051,9419,0,0
2003,25,Massachusetts,White,21473,15940,35441,25641,26010,9431,18283,7358,.73389578,.71303773,,,0,0
2003,26,Michigan,Asian,1885,1640,3763,3295,2792,971,2431,864,.74196118,.7377845,,,0,0
2003,26,Michigan,Black,980,847,1472,1265,576,896,474,791,.39130434,.37470356,,,0,0
2003,26,Michigan,Hispanic,325,267,444,359,235,209,196,163,.52927929,.54596102,,,0,0
2003,26,Michigan,Total,27009,23145,42592,36334,28037,14555,23750,12584,.65826917,.65365773,16183,10507,0,0
2003,26,Michigan,White,22196,19002,34385,29278,22827,11558,19304,9974,.66386503,.65933466,,,0,0
2003,27,Minnesota,Asian,1133,994,1895,1662,1148,747,976,686,.60580474,.58724427,,,0,0
2003,27,Minnesota,Black,230,196,323,276,118,205,90,186,.36532506,.32608697,,,0,0
2003,27,Minnesota,Hispanic,95,88,138,127,70,68,65,62,.50724638,.51181102,,,0,0
2003,27,Minnesota,Total,16640,14538,25343,22030,16577,8766,14270,7760,.65410566,.64775306,9256,5882,0,0
2003,27,Minnesota,White,14434,12616,21837,18979,14502,7335,12511,6468,.6641022,.65920228,,,0,0
2003,28,Mississippi,Asian,83,52,144,73,99,45,43,30,.6875,.58904111,,,0,0
2003,28,Mississippi,Black,475,461,624,608,123,501,118,490,.19711539,.19407895,,,0,0
2003,28,Mississippi,Hispanic,8,6,8,6,2,6,2,4,.25,.33333334,,,0,0
2003,28,Mississippi,Total,2969,2118,4233,2899,1964,2269,1198,1701,.46397355,.41324595,1547,669,0,0
2003,28,Mississippi,White,2285,1510,3270,2078,1660,1610,983,1095,.50764525,.47305101,,,0,0
2003,29,Missouri,Asian,484,371,1020,787,768,252,572,215,.75294119,.72681069,,,0,0
2003,29,Missouri,Black,281,215,432,322,211,221,141,181,.48842594,.43788821,,,0,0
2003,29,Missouri,Hispanic,83,57,118,81,74,44,48,33,.62711865,.5925926,,,0,0
2003,29,Missouri,Total,8847,6267,15121,10418,10670,4451,7003,3415,.70564115,.67220193,4256,2766,0,0
2003,29,Missouri,White,7548,5313,12731,8678,9022,3709,5860,2818,.70866388,.6752708,,,0,0
2003,30,Montana,Asian,47,45,74,71,52,22,50,21,.7027027,.70422536,,,0,0
2003,30,Montana,Black,4,4,6,6,5,1,5,1,.83333331,.83333331,,,0,0
2003,30,Montana,Hispanic,23,21,35,33,19,16,18,15,.54285717,.54545456,,,0,0
2003,30,Montana,Total,1927,1789,2726,2557,1894,832,1786,771,.6947909,.69847476,1357,917,0,0
2003,30,Montana,White,1737,1610,2462,2306,1725,737,1624,682,.70064986,.7042498,,,0,0
2003,31,Nebraska,Asian,58,43,97,74,65,32,52,22,.67010307,.7027027,,,0,0
2003,31,Nebraska,Black,37,35,49,47,18,31,17,30,.36734694,.36170211,,,0,0
2003,31,Nebraska,Hispanic,28,22,38,28,19,19,14,14,.5,.5,,,0,0
2003,31,Nebraska,Total,1832,1419,2656,2039,1688,968,1261,778,.63554215,.61844039,1189,715,0,0
2003,31,Nebraska,White,1630,1261,2365,1812,1532,833,1137,675,.64778012,.62748343,,,0,0
2003,32,Nevada,Asian,586,522,1176,1046,668,508,578,468,.5680272,.55258125,,,0,0
2003,32,Nevada,Black,130,120,208,193,89,119,80,113,.42788461,.41450778,,,0,0
2003,32,Nevada,Hispanic,226,215,353,337,193,160,181,156,.5467422,.53709197,,,0,0
2003,32,Nevada,Total,4551,4139,8244,7468,4723,3521,4229,3239,.57290149,.56628281,2678,1688,0,0
2003,32,Nevada,White,3165,2893,5681,5170,3299,2382,2982,2188,.58070761,.57678914,,,0,0
2003,33,New Hampshire,Asian,267,99,461,157,354,107,108,49,.76789588,.6878981,,,0,0
2003,33,New Hampshire,Black,42,8,56,13,28,28,6,7,.5,.46153846,,,0,0
2003,33,New Hampshire,Hispanic,25,15,33,19,22,11,11,8,.66666669,.57894737,,,0,0
2003,33,New Hampshire,Total,4085,2767,5904,3807,4034,1870,2489,1318,.68326557,.65379566,2168,1491,0,0
2003,33,New Hampshire,White,3525,2531,4991,3444,3351,1640,2236,1208,.67140853,.64924508,,,0,0
2003,34,New Jersey,Asian,5084,4425,10290,9003,7901,2389,7023,1980,.76783288,.78007329,,,0,0
2003,34,New Jersey,Black,1204,988,1742,1402,730,1012,537,865,.41905856,.38302425,,,0,0
2003,34,New Jersey,Hispanic,523,435,769,637,417,352,333,304,.54226267,.52276295,,,0,0
2003,34,New Jersey,Total,31278,24998,55011,43941,39326,15685,31634,12307,.71487522,.71991992,16586,12027,0,0
2003,34,New Jersey,White,20631,16137,35934,28062,25935,9999,20417,7645,.72173983,.72756755,,,0,0
2003,35,New Mexico,Asian,175,149,308,263,183,125,145,118,.59415585,.5513308,,,0,0
2003,35,New Mexico,Black,65,57,93,79,32,61,22,57,.34408602,.27848101,,,0,0
2003,35,New Mexico,Hispanic,861,790,1244,1136,416,828,344,792,.33440515,.3028169,,,0,0
2003,35,New Mexico,Total,4942,4326,7666,6626,3502,4164,2735,3891,.45682234,.41276789,2767,1273,0,0
2003,35,New Mexico,White,2471,2179,4054,3494,2182,1872,1706,1788,.53823382,.4882656,,,0,0
2003,36,New York,Asian,9984,9072,19114,17537,12915,6199,11857,5680,.67568272,.67611337,,,0,0
2003,36,New York,Black,5093,4354,7287,6219,2523,4764,1980,4239,.34623301,.31837916,,,0,0
2003,36,New York,Hispanic,2124,1690,3037,2433,1536,1501,1207,1226,.50576228,.49609536,,,0,0
2003,36,New York,Total,89237,75029,149968,126905,96504,53464,81031,45874,.64349729,.63851702,44095,29479,0,0
2003,36,New York,White,59507,49597,101490,85104,68031,33459,56764,28340,.67032218,.6669957,,,0,0
2003,37,North Carolina,Asian,1531,1341,3411,3026,2057,1354,1741,1285,.60304898,.57534701,,,0,0
2003,37,North Carolina,Black,3134,3014,5105,4910,1276,3829,1157,3753,.24995103,.23564155,,,0,0
2003,37,North Carolina,Hispanic,231,215,398,365,211,187,181,184,.53015077,.49589041,,,0,0
2003,37,North Carolina,Total,31098,27699,55678,49287,32309,23369,27557,21730,.58028305,.55911297,16671,10266,0,0
2003,37,North Carolina,White,24508,21638,43766,38375,27075,16691,23091,15284,.61863089,.60171986,,,0,0
2003,38,North Dakota,Asian,24,24,44,44,39,5,39,5,.88636363,.88636363,,,0,0
2003,38,North Dakota,Black,4,4,5,5,2,3,2,3,.40000001,.40000001,,,0,0
2003,38,North Dakota,Hispanic,3,3,5,5,3,2,3,2,.60000002,.60000002,,,0,0
2003,38,North Dakota,Total,910,889,1291,1264,891,400,868,396,.69016266,.68670887,673,473,0,0
2003,38,North Dakota,White,854,833,1195,1168,816,379,793,375,.68284518,.67893833,,,0,0
2003,39,Ohio,Asian,1507,1200,3155,2505,2424,731,1900,605,.76830429,.75848305,,,0,0
2003,39,Ohio,Black,1270,1095,1805,1555,568,1237,414,1141,.31468144,.26623794,,,0,0
2003,39,Ohio,Hispanic,199,160,272,219,149,123,115,104,.5477941,.52511418,,,0,0
2003,39,Ohio,Total,30264,23690,48225,37486,31935,16290,24232,13254,.66220838,.64642799,15428,9764,0,0
2003,39,Ohio,White,25773,20076,40504,31303,27148,13356,20588,10715,.67025477,.65770054,,,0,0
2003,40,Oklahoma,Asian,587,524,1192,1054,675,517,576,478,.56627518,.54648954,,,0,0
2003,40,Oklahoma,Black,479,452,707,667,210,497,193,474,.2970297,.28935531,,,0,0
2003,40,Oklahoma,Hispanic,288,268,434,408,190,244,176,232,.43778801,.43137255,,,0,0
2003,40,Oklahoma,Total,10442,9430,16725,14991,8340,8385,7159,7832,.49865472,.47755319,5855,2972,0,0
2003,40,Oklahoma,White,7715,6944,12215,10919,6248,5967,5376,5543,.51150227,.49235278,,,0,0
2003,41,Oregon,Asian,581,519,952,859,639,313,571,288,.67121851,.66472644,,,0,0
2003,41,Oregon,Black,61,55,91,83,34,57,29,54,.37362638,.3493976,,,0,0
2003,41,Oregon,Hispanic,130,120,168,153,106,62,95,58,.63095236,.62091506,,,0,0
2003,41,Oregon,Total,6326,5540,9268,8036,6285,2983,5355,2681,.67813987,.66637629,4012,2619,0,0
2003,41,Oregon,White,5096,4446,7357,6342,5017,2340,4254,2088,.68193555,.67076629,,,0,0
2003,42,Pennsylvania,Asian,2016,1571,3786,2985,2824,962,2251,734,.745906,.75410384,,,0,0
2003,42,Pennsylvania,Black,776,587,1042,772,407,635,273,499,.39059502,.35362694,,,0,0
2003,42,Pennsylvania,Hispanic,236,183,348,262,191,157,138,124,.5488506,.52671754,,,0,0
2003,42,Pennsylvania,Total,32335,24535,51667,38700,35564,16103,26660,12040,.68833107,.68888891,16594,11421,0,0
2003,42,Pennsylvania,White,27526,20989,43538,32712,30037,13501,22605,10107,.68990308,.6910308,,,0,0
2003,44,Rhode Island,Asian,144,94,273,152,182,91,95,57,.66666669,.625,,,0,0
2003,44,Rhode Island,Black,52,31,85,44,40,45,9,35,.47058824,.20454545,,,0,0
2003,44,Rhode Island,Hispanic,17,14,21,17,10,11,8,9,.47619048,.47058824,,,0,0
2003,44,Rhode Island,Total,2576,1541,4048,2226,2598,1450,1325,901,.64179844,.59523809,1061,677,0,0
2003,44,Rhode Island,White,2124,1259,3318,1811,2147,1171,1097,714,.64707655,.60574269,,,0,0
2003,45,South Carolina,Asian,504,464,1012,948,638,374,596,352,.63043481,.62869197,,,1,1
2003,45,South Carolina,Black,1545,1517,2279,2222,697,1582,657,1565,.3058359,.29567957,,,1,1
2003,45,South Carolina,Hispanic,87,84,132,126,70,62,67,59,.530303,.53174603,,,1,1
2003,45,South Carolina,Total,12013,10680,19765,17472,11419,8346,9882,7590,.5777384,.56559068,6873,4112,1,1
2003,45,South Carolina,White,9347,8148,15436,13387,9433,6003,8064,5323,.61110389,.60237545,,,1,1
2003,46,South Dakota,Asian,36,36,97,97,67,30,67,30,.69072163,.69072163,,,0,0
2003,46,South Dakota,Black,4,4,6,6,4,2,4,2,.66666669,.66666669,,,0,0
2003,46,South Dakota,Hispanic,8,8,10,10,6,4,6,4,.60000002,.60000002,,,0,0
2003,46,South Dakota,Total,1606,1528,2539,2433,1560,979,1503,930,.61441511,.61775583,1046,627,0,0
2003,46,South Dakota,White,1487,1415,2330,2232,1429,901,1377,855,.61330473,.61693549,,,0,0
2003,47,Tennessee,Asian,605,473,1209,927,869,340,653,274,.71877587,.70442289,,,0,0
2003,47,Tennessee,Black,1237,1136,1768,1609,565,1203,481,1128,.31957012,.29894343,,,0,0
2003,47,Tennessee,Hispanic,71,60,107,89,59,48,45,44,.55140185,.50561798,,,0,0
2003,47,Tennessee,Total,11785,8688,19246,13722,12570,6676,8356,5366,.65312272,.60894912,5658,3401,0,0
2003,47,Tennessee,White,9360,6672,15218,10488,10436,4782,6801,3687,.68576688,.64845538,,,0,0
2003,48,Texas,Asian,7716,7237,18055,17007,11611,6444,10782,6225,.64309055,.63397425,,,0,0
2003,48,Texas,Black,4913,4752,8129,7842,2181,5948,2009,5833,.26829869,.25618464,,,0,0
2003,48,Texas,Hispanic,18554,17920,29628,28634,11695,17933,11067,17567,.39472795,.38649857,,,0,0
2003,48,Texas,Total,90880,84541,164804,153079,85545,79259,77093,75986,.51907116,.5036158,48500,28311,0,0
2003,48,Texas,White,48484,44096,90578,82432,51105,39473,45186,37246,.56420988,.54816091,,,0,0
2003,49,Utah,Asian,545,500,1022,947,679,343,630,317,.66438359,.66525871,,,0,0
2003,49,Utah,Black,32,27,46,35,19,27,17,18,.41304347,.48571429,,,0,0
2003,49,Utah,Hispanic,213,192,313,279,182,131,162,117,.58146966,.58064514,,,0,0
2003,49,Utah,Total,13454,12806,22172,21036,14909,7263,14102,6934,.67242467,.67037457,7941,5665,0,0
2003,49,Utah,White,11934,11407,19649,18709,13274,6375,12594,6115,.675556,.67315197,,,0,0
2003,50,Vermont,Asian,81,49,141,93,96,45,64,29,.68085104,.68817204,,,0,0
2003,50,Vermont,Black,16,13,23,19,14,9,11,8,.60869563,.57894737,,,0,0
2003,50,Vermont,Hispanic,7,5,9,7,7,2,5,2,.77777779,.71428573,,,0,0
2003,50,Vermont,Total,2227,1890,3360,2817,2260,1100,1841,976,.67261904,.65353215,1371,957,0,0
2003,50,Vermont,White,2039,1752,3054,2594,2050,1004,1692,902,.67125082,.65227449,,,0,0
2003,51,Virginia,Asian,3783,3513,7863,7307,4715,3148,4334,2973,.59964389,.59312987,,,0,0
2003,51,Virginia,Black,2664,2528,4148,3916,1462,2686,1325,2591,.35245901,.33835545,,,0,0
2003,51,Virginia,Hispanic,428,397,724,658,415,309,374,284,.5732044,.56838906,,,0,0
2003,51,Virginia,Total,36597,32325,65933,57761,41037,24896,35320,22441,.62240458,.61148524,18765,12039,0,0
2003,51,Virginia,White,26323,22889,47204,40656,30881,16323,26245,14411,.65420306,.64553815,,,0,0
2003,53,Washington,Asian,2684,2415,4556,4107,2615,1941,2346,1761,.57396841,.57121986,,,0,0
2003,53,Washington,Black,365,310,500,426,163,337,133,293,.32600001,.31220657,,,0,0
2003,53,Washington,Hispanic,471,438,648,597,342,306,318,279,.52777779,.53266335,,,0,0
2003,53,Washington,Total,18251,15813,28378,24534,17886,10492,15244,9290,.63027698,.62134182,9688,6306,0,0
2003,53,Washington,White,13125,11315,20209,17362,13238,6971,11204,6158,.65505469,.64531738,,,0,0
2003,54,West Virginia,Asian,135,121,268,246,185,83,172,74,.6902985,.69918698,,,0,0
2003,54,West Virginia,Black,40,37,52,49,12,40,10,39,.23076923,.20408164,,,0,0
2003,54,West Virginia,Hispanic,5,5,8,8,2,6,2,6,.25,.25,,,0,0
2003,54,West Virginia,Total,3096,2923,4791,4499,2276,2515,2076,2423,.47505739,.46143588,1943,959,0,0
2003,54,West Virginia,White,2808,2662,4295,4045,1986,2309,1809,2236,.46239814,.44721878,,,0,0
2003,55,Wisconsin,Asian,651,566,1145,981,783,362,663,318,.68384278,.67584097,,,0,0
2003,55,Wisconsin,Black,250,226,353,314,124,229,100,214,.35127479,.31847134,,,0,0
2003,55,Wisconsin,Hispanic,256,209,388,315,219,169,169,146,.56443298,.53650796,,,0,0
2003,55,Wisconsin,Total,18128,16178,28425,25253,19502,8923,17163,8090,.68608618,.67964202,11209,7734,0,0
2003,55,Wisconsin,White,16297,14593,25456,22704,17639,7817,15596,7108,.6929211,.68692744,,,0,0
2003,56,Wyoming,Asian,22,22,34,34,15,19,15,19,.44117647,.44117647,,,0,0
2003,56,Wyoming,Black,5,5,8,8,2,6,2,6,.25,.25,,,0,0
2003,56,Wyoming,Hispanic,23,23,36,36,20,16,20,16,.55555558,.55555558,,,0,0
2003,56,Wyoming,Total,850,850,1331,1331,721,610,721,610,.54169798,.54169798,613,361,0,0
2003,56,Wyoming,White,755,755,1176,1176,640,536,640,536,.54421771,.54421771,,,0,0
2004,1,Alabama,Asian,357,294,790,658,590,200,493,165,.74683547,.7492401,,,0,0
2004,1,Alabama,Black,622,592,815,770,245,570,221,549,.30061349,.28701299,,,0,0
2004,1,Alabama,Hispanic,35,32,58,53,31,27,26,27,.53448278,.49056605,,,0,0
2004,1,Alabama,Total,6629,5059,10625,8036,6448,4177,4766,3270,.60687059,.59308112,3216,1823,0,0
2004,1,Alabama,White,5348,3948,8534,6242,5312,3222,3819,2423,.62245136,.61182314,,,0,0
2004,2,Alaska,Asian,150,144,312,302,184,128,177,125,.58974361,.58609271,,,0,0
2004,2,Alaska,Black,26,25,39,37,9,30,8,29,.23076923,.21621622,,,0,0
2004,2,Alaska,Hispanic,29,27,48,46,34,14,34,12,.70833331,.73913044,,,0,0
2004,2,Alaska,Total,1869,1764,3252,3121,2087,1165,2022,1099,.64175892,.64786929,1183,781,0,0
2004,2,Alaska,White,1468,1389,2541,2443,1669,872,1621,822,.65682805,.66352844,,,0,0
2004,4,Arizona,Asian,906,819,1816,1624,1193,623,1055,569,.65693831,.64963055,,,0,0
2004,4,Arizona,Black,204,177,323,278,150,173,126,152,.4643963,.45323741,,,0,0
2004,4,Arizona,Hispanic,1191,1052,1835,1592,939,896,794,798,.5117166,.49874371,,,0,0
2004,4,Arizona,Total,11535,9893,19590,16483,12387,7203,10223,6260,.63231242,.62021476,6352,3641,0,0
2004,4,Arizona,White,8016,6794,13733,11424,9034,4699,7392,4032,.65783149,.64705884,,,0,0
2004,5,Arkansas,Asian,264,246,554,520,293,261,276,244,.52888089,.53076923,,,0,0
2004,5,Arkansas,Black,602,595,883,874,120,763,118,756,.13590033,.13501143,,,0,0
2004,5,Arkansas,Hispanic,106,101,180,173,90,90,88,85,.5,.50867051,,,0,0
2004,5,Arkansas,Total,6674,6100,11112,10197,4881,6231,4394,5803,.43925485,.43091106,3469,1658,0,0
2004,5,Arkansas,White,5339,4819,8901,8073,4075,4826,3626,4447,.45781374,.44915149,,,0,0
2004,6,California,Asian,45995,41020,93188,83213,55854,37334,49164,34049,.59936899,.59082115,,,0,0
2004,6,California,Black,5934,5162,9603,8301,3170,6433,2476,5825,.33010519,.29827732,,,0,0
2004,6,California,Hispanic,35569,32913,55680,51535,27004,28676,24406,27129,.48498562,.47358108,,,0,0
2004,6,California,Total,191593,165111,344089,294900,204441,139648,169587,125313,.5941515,.57506615,90371,64231,0,0
2004,6,California,White,72344,59101,131688,106713,87664,44024,68922,37791,.66569465,.64586318,,,0,0
2004,8,Colorado,Asian,1128,1055,1961,1839,1181,780,1097,742,.60224378,.59651983,,,0,0
2004,8,Colorado,Black,471,456,685,664,250,435,230,434,.3649635,.34638554,,,0,0
2004,8,Colorado,Hispanic,887,850,1312,1261,628,684,594,667,.47865853,.47105473,,,0,0
2004,8,Colorado,Total,18660,17210,30144,27745,19322,10822,17534,10211,.6409899,.63196975,10482,7254,0,0
2004,8,Colorado,White,14576,13374,23768,21759,15851,7917,14353,7406,.66690511,.65963507,,,0,0
2004,9,Connecticut,Asian,1284,866,2518,1631,1897,621,1190,441,.75337571,.72961372,,,0,0
2004,9,Connecticut,Black,682,537,1003,774,377,626,218,556,.37587237,.28165373,,,0,0
2004,9,Connecticut,Hispanic,369,311,523,434,276,247,212,222,.52772468,.48847926,,,0,0
2004,9,Connecticut,Total,17257,12841,29634,21230,21760,7874,15154,6076,.73429167,.71380121,7914,6085,0,0
2004,9,Connecticut,White,13315,9949,22901,16508,17225,5676,12209,4299,.75215054,.73958081,,,0,0
2004,10,Delaware,Asian,291,220,687,512,495,192,343,169,.72052401,.66992188,,,0,0
2004,10,Delaware,Black,184,156,271,226,104,167,78,148,.38376385,.34513274,,,0,0
2004,10,Delaware,Hispanic,33,25,57,44,28,29,22,22,.49122807,.5,,,0,0
2004,10,Delaware,Total,3237,2092,5764,3624,3714,2050,2014,1610,.64434421,.55573952,1315,772,0,0
2004,10,Delaware,White,2511,1534,4332,2554,2842,1490,1419,1135,.656048,.55559903,,,0,0
2004,11,District Of Columbia,Asian,149,49,290,84,194,96,27,57,.66896552,.32142857,,,0,0
2004,11,District Of Columbia,Black,667,481,1006,694,245,761,90,604,.24353877,.129683,,,0,0
2004,11,District Of Columbia,Hispanic,22,5,43,7,28,15,3,4,.6511628,.42857143,,,0,0
2004,11,District Of Columbia,Total,2602,899,4930,1539,3249,1681,535,1004,.65902638,.34762833,616,249,0,0
2004,11,District Of Columbia,White,1287,161,2726,407,2210,516,267,140,.81071168,.65601963,,,0,0
2004,12,Florida,Asian,4772,4331,10344,9305,5711,4633,5005,4300,.55210751,.53788286,,,0,1
2004,12,Florida,Black,6287,6027,10259,9781,3029,7230,2788,6993,.29525295,.28504243,,,0,1
2004,12,Florida,Hispanic,2777,2545,4400,3968,2096,2304,1813,2155,.47636363,.45690525,,,0,1
2004,12,Florida,Total,77309,67602,140297,121470,73587,66710,61034,60436,.52450871,.50246149,36539,25232,0,1
2004,12,Florida,White,44499,38736,82522,71107,45191,37331,37525,33582,.54762363,.52772582,,,0,1
2004,13,Georgia,Asian,2717,2475,5240,4732,3491,1749,3100,1632,.66622138,.65511411,,,0,0
2004,13,Georgia,Black,4749,4534,6697,6337,1783,4914,1594,4743,.2662386,.25153857,,,0,0
2004,13,Georgia,Hispanic,345,309,534,466,299,235,252,214,.55992508,.54077256,,,0,0
2004,13,Georgia,Total,30610,25779,48658,40040,29049,19609,22573,17467,.59700358,.56376123,14972,8226,0,0
2004,13,Georgia,White,20627,16622,32826,25722,21455,11371,16044,9678,.65359777,.62374622,,,0,0
2004,15,Hawaii,Asian,2631,1369,4316,1989,2793,1523,989,1000,.64712697,.49723479,,,0,0
2004,15,Hawaii,Black,38,27,52,37,23,29,16,21,.44230768,.43243244,,,0,0
2004,15,Hawaii,Hispanic,58,33,98,49,58,40,24,25,.59183675,.48979592,,,0,0
2004,15,Hawaii,Total,4029,2094,6584,3068,4306,2278,1575,1493,.6540097,.51336378,1474,795,0,0
2004,15,Hawaii,White,797,427,1309,655,882,427,371,284,.67379677,.56641221,,,0,0
2004,16,Idaho,Asian,109,102,199,189,141,58,134,55,.7085427,.70899469,,,0,0
2004,16,Idaho,Black,13,13,26,26,17,9,17,9,.65384614,.65384614,,,0,0
2004,16,Idaho,Hispanic,69,66,87,84,34,53,33,51,.39080459,.39285713,,,0,0
2004,16,Idaho,Total,3043,2915,4821,4626,3255,1566,3111,1515,.67517114,.67250323,1913,1259,0,0
2004,16,Idaho,White,2669,2559,4189,4019,2838,1351,2711,1308,.67748868,.67454588,,,0,0
2004,17,Illinois,Asian,4966,4542,10383,9584,7822,2561,7268,2316,.7533468,.75834727,,,0,0
2004,17,Illinois,Black,2258,1939,3153,2691,1051,2102,837,1854,.33333334,.3110368,,,0,0
2004,17,Illinois,Hispanic,2749,2209,4001,3258,1945,2056,1504,1754,.48612848,.46163291,,,0,0
2004,17,Illinois,Total,41733,35045,73150,61965,53189,19961,45261,16704,.72712237,.73042846,21710,16593,0,0
2004,17,Illinois,White,28738,23839,50453,42121,38785,11668,32666,9455,.76873523,.77552766,,,0,0
2004,18,Indiana,Asian,695,576,1460,1224,965,495,797,427,.66095889,.65114379,,,0,0
2004,18,Indiana,Black,539,469,779,663,251,528,176,487,.32220796,.26546004,,,0,0
2004,18,Indiana,Hispanic,192,170,292,255,112,180,87,168,.38356164,.34117648,,,0,0
2004,18,Indiana,Total,14839,12657,23326,19555,12485,10841,10015,9540,.53523964,.51214522,8926,4313,0,0
2004,18,Indiana,White,12746,10900,19718,16562,10542,9176,8505,8057,.5346384,.51352495,,,0,0
2004,19,Iowa,Asian,269,248,490,455,380,110,357,98,.77551019,.7846154,,,0,0
2004,19,Iowa,Black,35,35,50,50,21,29,21,29,.41999999,.41999999,,,0,0
2004,19,Iowa,Hispanic,48,48,69,69,42,27,42,27,.60869563,.60869563,,,0,0
2004,19,Iowa,Total,5425,4851,8192,7369,5667,2525,5150,2219,.69177246,.69887364,3275,2266,0,0
2004,19,Iowa,White,4813,4281,7168,6407,4925,2243,4449,1958,.68708146,.69439673,,,0,0
2004,20,Kansas,Asian,351,325,631,574,457,174,418,156,.72424722,.72822303,,,0,0
2004,20,Kansas,Black,145,141,170,166,62,108,60,106,.36470589,.36144578,,,0,0
2004,20,Kansas,Hispanic,77,75,93,91,62,31,62,29,.66666669,.6813187,,,0,0
2004,20,Kansas,Total,4553,4157,6854,6239,4744,2110,4353,1886,.69215059,.69770795,2679,1900,0,0
2004,20,Kansas,White,3703,3365,5544,5028,3875,1669,3546,1482,.69895381,.70525062,,,0,0
2004,21,Kentucky,Asian,415,365,786,693,532,254,467,226,.67684478,.67388165,,,0,0
2004,21,Kentucky,Black,374,344,537,492,151,386,127,365,.2811918,.25813007,,,0,0
2004,21,Kentucky,Hispanic,64,57,90,81,49,41,44,37,.54444444,.54320985,,,0,0
2004,21,Kentucky,Total,11457,9458,18348,14800,9040,9308,6774,8026,.49269676,.4577027,5555,2910,0,0
2004,21,Kentucky,White,10117,8274,16111,12839,7886,8225,5800,7039,.48947924,.45174858,,,0,0
2004,22,Louisiana,Asian,316,227,566,399,390,176,269,130,.68904597,.67418545,,,0,0
2004,22,Louisiana,Black,447,347,608,472,244,364,187,285,.40131578,.39618644,,,0,0
2004,22,Louisiana,Hispanic,32,17,42,24,26,16,14,10,.61904764,.58333331,,,0,0
2004,22,Louisiana,Total,4402,2313,6644,3362,4045,2599,1830,1532,.60881996,.54431885,1635,925,0,0
2004,22,Louisiana,White,3274,1540,4917,2184,3066,1851,1196,988,.62355095,.54761904,,,0,0
2004,23,Maine,Asian,159,85,248,133,136,112,87,46,.54838711,.65413535,,,0,0
2004,23,Maine,Black,28,17,43,30,27,16,21,9,.62790698,.69999999,,,0,0
2004,23,Maine,Hispanic,17,13,26,17,10,16,5,12,.38461539,.29411766,,,0,0
2004,23,Maine,Total,4975,3974,7408,5813,4581,2827,3611,2202,.61838555,.62119389,2893,1700,0,0
2004,23,Maine,White,4539,3680,6721,5343,4168,2553,3315,2028,.6201458,.62043798,,,0,0
2004,24,Maryland,Asian,3881,3549,8449,7777,5973,2476,5503,2274,.70694757,.70759934,,,0,0
2004,24,Maryland,Black,3686,3327,5692,5123,2090,3602,1771,3352,.36718202,.34569588,,,0,0
2004,24,Maryland,Hispanic,319,276,560,486,319,241,262,224,.56964284,.53909463,,,0,0
2004,24,Maryland,Total,33631,28261,61620,52199,41150,20470,34306,17893,.66780263,.65721565,15294,10257,0,0
2004,24,Maryland,White,22115,18014,40524,33379,28515,12009,23223,10156,.70365709,.69573683,,,0,0
2004,25,Massachusetts,Asian,2681,2020,5341,4031,4005,1336,2925,1106,.74985957,.72562641,,,0,0
2004,25,Massachusetts,Black,852,642,1248,903,582,666,340,563,.46634614,.37652269,,,0,0
2004,25,Massachusetts,Hispanic,296,251,439,350,264,175,189,161,.60136676,.54000002,,,0,0
2004,25,Massachusetts,Total,28977,21596,48661,35584,35601,13060,25143,10441,.73161256,.70658159,13869,10557,0,0
2004,25,Massachusetts,White,22396,16669,37037,26984,27477,9560,19450,7534,.74187976,.72079754,,,0,0
2004,26,Michigan,Asian,2010,1747,3919,3419,2941,978,2552,867,.75044656,.74641711,,,0,0
2004,26,Michigan,Black,1017,912,1527,1363,563,964,466,897,.36869678,.3418929,,,0,0
2004,26,Michigan,Hispanic,369,314,502,413,289,213,235,178,.57569718,.56900728,,,0,0
2004,26,Michigan,Total,28166,24070,44652,38020,29566,15086,24944,13076,.66214281,.65607578,16272,10772,0,0
2004,26,Michigan,White,22911,19510,35840,30391,23964,11876,20171,10220,.66863841,.66371626,,,0,0
2004,27,Minnesota,Asian,1198,1031,2111,1809,1188,923,1002,807,.56276643,.5538972,,,0,0
2004,27,Minnesota,Black,254,209,370,303,131,239,91,212,.35405406,.30033004,,,0,0
2004,27,Minnesota,Hispanic,113,96,150,127,85,65,73,54,.56666666,.57480317,,,0,0
2004,27,Minnesota,Total,17437,15144,27007,23370,18081,8926,15468,7902,.66949308,.66187418,9505,6264,0,0
2004,27,Minnesota,White,14941,12999,22892,19861,15699,7193,13486,6375,.68578541,.67901921,,,0,0
2004,28,Mississippi,Asian,100,68,174,109,98,76,56,53,.56321841,.51376146,,,0,0
2004,28,Mississippi,Black,607,583,847,813,159,688,145,668,.18772137,.17835179,,,0,0
2004,28,Mississippi,Hispanic,9,7,11,8,3,8,3,5,.27272728,.375,,,0,0
2004,28,Mississippi,Total,3223,2380,4688,3320,2122,2566,1378,1942,.45264506,.41506025,1622,688,0,0
2004,28,Mississippi,White,2373,1610,3451,2230,1745,1706,1091,1139,.50565052,.48923767,,,0,0
2004,29,Missouri,Asian,514,384,1155,870,903,252,667,203,.78181821,.76666665,,,0,0
2004,29,Missouri,Black,293,220,411,296,226,185,146,150,.54987836,.49324325,,,0,0
2004,29,Missouri,Hispanic,94,64,153,98,93,60,52,46,.60784316,.53061223,,,0,0
2004,29,Missouri,Total,9549,6826,16269,11328,11531,4738,7615,3713,.70877129,.6722281,4412,3073,0,0
2004,29,Missouri,White,8114,5783,13636,9427,9650,3986,6312,3115,.70768553,.66956615,,,0,0
2004,30,Montana,Asian,50,46,88,83,54,34,54,29,.61363637,.6506024,,,0,0
2004,30,Montana,Black,2,1,3,1,2,1,1,0,.66666669,1,,,0,0
2004,30,Montana,Hispanic,14,14,20,20,9,11,9,11,.44999999,.44999999,,,0,0
2004,30,Montana,Total,1996,1845,3029,2840,2144,885,2011,829,.70782435,.70809859,1382,924,0,0
2004,30,Montana,White,1820,1681,2744,2575,1965,779,1843,732,.71610785,.71572816,,,0,0
2004,31,Nebraska,Asian,92,75,126,104,74,52,62,42,.58730161,.59615386,,,0,0
2004,31,Nebraska,Black,44,39,55,49,11,44,9,40,.2,.18367347,,,0,0
2004,31,Nebraska,Hispanic,37,33,46,42,19,27,15,27,.41304347,.35714287,,,0,0
2004,31,Nebraska,Total,2288,1819,3270,2569,2059,1211,1560,1009,.62966359,.6072402,1230,812,0,0
2004,31,Nebraska,White,1987,1574,2861,2232,1852,1009,1392,840,.64732611,.62365592,,,0,0
2004,32,Nevada,Asian,739,651,1573,1397,846,727,731,666,.53782582,.52326411,,,0,0
2004,32,Nevada,Black,151,141,256,236,95,161,82,154,.37109375,.34745762,,,0,0
2004,32,Nevada,Hispanic,332,318,537,514,267,270,252,262,.49720672,.49027237,,,0,0
2004,32,Nevada,Total,5411,4947,9847,8965,5639,4208,5066,3899,.5726617,.56508642,2978,1885,0,0
2004,32,Nevada,White,3606,3307,6431,5873,3863,2568,3504,2369,.60068417,.59662867,,,0,0
2004,33,New Hampshire,Asian,262,102,452,153,331,121,106,47,.73230088,.69281048,,,0,0
2004,33,New Hampshire,Black,39,17,62,23,39,23,10,13,.62903225,.43478259,,,0,0
2004,33,New Hampshire,Hispanic,20,16,31,24,23,8,17,7,.74193549,.70833331,,,0,0
2004,33,New Hampshire,Total,4276,2935,6344,4128,4394,1950,2723,1405,.69262296,.65964144,2211,1451,0,0
2004,33,New Hampshire,White,3660,2645,5334,3703,3663,1671,2442,1261,.68672663,.65946531,,,0,0
2004,34,New Jersey,Asian,5286,4596,10990,9546,8446,2544,7412,2134,.76851684,.77645087,,,0,0
2004,34,New Jersey,Black,1378,1128,2044,1660,846,1198,642,1018,.41389433,.386747,,,0,0
2004,34,New Jersey,Hispanic,606,493,883,705,481,402,373,332,.54473388,.52907801,,,0,0
2004,34,New Jersey,Total,33494,26813,59545,47565,42463,17082,34229,13336,.71312451,.71962577,17284,12993,0,0
2004,34,New Jersey,White,21892,17122,38391,29985,27806,10585,22017,7968,.72428435,.73426712,,,0,0
2004,35,New Mexico,Asian,169,143,335,271,209,126,161,110,.62388062,.59409595,,,0,0
2004,35,New Mexico,Black,66,60,106,95,33,73,26,69,.31132075,.2736842,,,0,0
2004,35,New Mexico,Hispanic,1012,943,1474,1363,522,952,444,919,.3541384,.32575202,,,0,0
2004,35,New Mexico,Total,5312,4627,8532,7316,4134,4398,3262,4054,.48452884,.44587207,3080,1449,0,0
2004,35,New Mexico,White,2677,2332,4512,3879,2545,1967,2055,1824,.56405139,.52977574,,,0,0
2004,36,New York,Asian,10349,9404,19228,17563,12837,6391,11762,5801,.66762012,.66970336,,,0,0
2004,36,New York,Black,5291,4462,7662,6453,2806,4856,2198,4255,.36622292,.34061676,,,0,0
2004,36,New York,Hispanic,2348,1871,3313,2655,1557,1756,1193,1462,.4699668,.44934088,,,0,0
2004,36,New York,Total,93952,79187,157568,133600,101581,55987,85557,48043,.64468038,.64039671,45523,30216,0,0
2004,36,New York,White,62343,52190,106159,89366,71458,34701,59921,29445,.67312241,.67051226,,,0,0
2004,37,North Carolina,Asian,1705,1499,3810,3368,2336,1474,1989,1379,.61312336,.59055817,,,0,0
2004,37,North Carolina,Black,3529,3417,5844,5649,1449,4395,1319,4330,.24794661,.23349266,,,0,0
2004,37,North Carolina,Hispanic,295,270,489,447,231,258,202,245,.47239265,.45190156,,,0,0
2004,37,North Carolina,Total,33900,30053,61526,54155,34978,26548,29634,24521,.56850761,.54720712,17936,11396,0,0
2004,37,North Carolina,White,26342,23107,47729,41557,28864,18865,24408,17149,.60474765,.58733785,,,0,0
2004,38,North Dakota,Asian,30,30,51,51,39,12,39,12,.7647059,.7647059,,,0,0
2004,38,North Dakota,Black,3,3,3,3,2,1,2,1,.66666669,.66666669,,,0,0
2004,38,North Dakota,Hispanic,3,3,4,4,0,4,0,4,0,0,,,0,0
2004,38,North Dakota,Total,911,889,1279,1253,878,401,854,399,.68647379,.68156427,666,450,0,0
2004,38,North Dakota,White,840,818,1176,1150,809,367,785,365,.68792516,.68260872,,,0,0
2004,39,Ohio,Asian,1658,1359,3560,2915,2721,839,2229,686,.76432586,.76466554,,,0,0
2004,39,Ohio,Black,1389,1214,1959,1697,640,1319,488,1209,.32669729,.2875663,,,0,0
2004,39,Ohio,Hispanic,251,203,376,306,214,162,168,138,.56914896,.54901963,,,0,0
2004,39,Ohio,Total,32396,25512,52079,40726,34514,17565,26256,14470,.66272396,.64469874,16581,11189,0,0
2004,39,Ohio,White,27278,21377,43279,33671,29018,14261,22041,11630,.67048687,.65459889,,,0,0
2004,40,Oklahoma,Asian,601,540,1247,1118,736,511,628,490,.59021652,.56171733,,,0,0
2004,40,Oklahoma,Black,520,500,767,739,190,577,174,565,.24771838,.23545332,,,0,0
2004,40,Oklahoma,Hispanic,320,298,463,430,216,247,196,234,.46652266,.45581394,,,0,0
2004,40,Oklahoma,Total,10782,9789,17461,15764,8673,8788,7466,8298,.49670693,.47361076,6071,3054,0,0
2004,40,Oklahoma,White,7797,7020,12589,11268,6472,6117,5532,5736,.5140996,.49094781,,,0,0
2004,41,Oregon,Asian,695,604,1126,983,737,389,635,348,.65452933,.64598167,,,0,0
2004,41,Oregon,Black,45,42,50,47,23,27,22,25,.46000001,.46808511,,,0,0
2004,41,Oregon,Hispanic,150,138,186,169,109,77,99,70,.58602148,.5857988,,,0,0
2004,41,Oregon,Total,7079,6140,10311,8792,6865,3446,5727,3065,.66579384,.65138763,4180,2900,0,0
2004,41,Oregon,White,5630,4889,8159,6950,5455,2704,4554,2396,.66858685,.6552518,,,0,0
2004,42,Pennsylvania,Asian,2247,1788,4179,3388,2968,1211,2422,966,.71021777,.71487606,,,0,0
2004,42,Pennsylvania,Black,1057,849,1402,1107,446,956,297,810,.31811696,.2682927,,,0,0
2004,42,Pennsylvania,Hispanic,334,271,484,383,253,231,200,183,.52272725,.52219319,,,0,0
2004,42,Pennsylvania,Total,35021,26854,56520,42846,38248,18272,28757,14089,.67671621,.67117119,18059,12471,0,0
2004,42,Pennsylvania,White,29167,22368,46844,35463,32098,14746,24168,11295,.68521047,.681499,,,0,0
2004,44,Rhode Island,Asian,129,83,223,131,156,67,88,43,.69955158,.67175573,,,0,0
2004,44,Rhode Island,Black,42,21,59,25,27,32,11,14,.45762712,.44,,,0,0
2004,44,Rhode Island,Hispanic,16,10,27,16,19,8,11,5,.7037037,.6875,,,0,0
2004,44,Rhode Island,Total,2829,1666,4577,2488,3040,1537,1524,964,.66419053,.61254019,1112,722,0,0
2004,44,Rhode Island,White,2414,1434,3921,2156,2608,1313,1313,843,.66513646,.60899812,,,0,0
2004,45,South Carolina,Asian,507,459,1042,948,685,357,621,327,.65738964,.65506327,,,1,1
2004,45,South Carolina,Black,1490,1467,2173,2135,645,1528,625,1510,.29682466,.29274005,,,1,1
2004,45,South Carolina,Hispanic,85,77,126,115,69,57,64,51,.54761904,.55652171,,,1,1
2004,45,South Carolina,Total,12315,10982,20371,18039,11635,8736,10032,8007,.57115507,.55612838,6615,3722,1,1
2004,45,South Carolina,White,9600,8426,15994,13951,9643,6351,8227,5724,.60291362,.58970684,,,1,1
2004,46,South Dakota,Asian,45,45,79,79,49,30,49,30,.62025315,.62025315,,,0,0
2004,46,South Dakota,Black,14,12,25,23,10,15,9,14,.40000001,.39130434,,,0,0
2004,46,South Dakota,Hispanic,7,6,8,7,3,5,3,4,.375,.42857143,,,0,0
2004,46,South Dakota,Total,1833,1717,2963,2776,1795,1168,1693,1083,.60580492,.60987031,1188,747,0,0
2004,46,South Dakota,White,1701,1593,2734,2561,1658,1076,1564,997,.60643744,.61069894,,,0,0
2004,47,Tennessee,Asian,734,592,1501,1176,1034,467,783,393,.68887407,.66581631,,,0,0
2004,47,Tennessee,Black,1241,1131,1778,1594,615,1163,522,1072,.34589428,.32747805,,,0,0
2004,47,Tennessee,Hispanic,109,89,159,132,91,68,71,61,.57232702,.53787881,,,0,0
2004,47,Tennessee,Total,12734,9239,21017,14729,13808,7209,9018,5711,.65699196,.61226153,5824,3642,0,0
2004,47,Tennessee,White,10049,6997,16526,11092,11367,5159,7190,3902,.68782526,.64821494,,,0,0
2004,48,Texas,Asian,8663,8188,20213,19154,12670,7543,11844,7310,.62682432,.61835647,,,0,0
2004,48,Texas,Black,5981,5787,9882,9577,2458,7424,2306,7271,.24873507,.24078521,,,0,0
2004,48,Texas,Hispanic,20650,19939,32684,31586,12750,19934,12090,19496,.39009914,.38276452,,,0,0
2004,48,Texas,Total,101115,94328,183130,170813,93321,89809,84497,86316,.50958884,.49467546,53542,31986,0,0
2004,48,Texas,White,52018,47390,97605,89110,54657,42948,48429,40681,.55998158,.54347438,,,0,0
2004,49,Utah,Asian,575,517,1078,979,718,360,654,325,.66604823,.66802859,,,0,0
2004,49,Utah,Black,50,44,76,64,42,34,38,26,.55263156,.59375,,,0,0
2004,49,Utah,Hispanic,252,236,363,332,223,140,203,129,.61432505,.61144578,,,0,0
2004,49,Utah,Total,14068,13416,23252,22018,15831,7421,14997,7021,.68084466,.68112451,7984,5839,0,0
2004,49,Utah,White,12221,11710,20223,19250,13829,6394,13163,6087,.68382537,.68379223,,,0,0
2004,50,Vermont,Asian,89,58,139,90,80,59,53,37,.57553959,.58888888,,,0,0
2004,50,Vermont,Black,9,6,12,7,6,6,3,4,.5,.42857143,,,0,0
2004,50,Vermont,Hispanic,15,7,27,11,22,5,8,3,.81481481,.72727275,,,0,0
2004,50,Vermont,Total,2380,1979,3608,2921,2435,1173,1921,1000,.67488915,.65765148,1485,994,0,0
2004,50,Vermont,White,2156,1827,3264,2698,2218,1046,1787,911,.67953432,.66234249,,,0,0
2004,51,Virginia,Asian,4188,3844,8537,7846,5166,3371,4707,3139,.60513061,.59992355,,,0,0
2004,51,Virginia,Black,2818,2673,4318,4078,1616,2702,1466,2612,.37424734,.35948995,,,0,0
2004,51,Virginia,Hispanic,470,434,785,725,458,327,420,305,.58343947,.57931036,,,0,0
2004,51,Virginia,Total,39464,34784,71009,62100,44935,26074,38739,23361,.63280714,.62381643,19457,12751,0,0
2004,51,Virginia,White,28023,24356,50438,43453,33494,16944,28590,14863,.6640628,.65795225,,,0,0
2004,53,Washington,Asian,2986,2740,5042,4619,2880,2162,2592,2027,.57120192,.56116045,,,0,0
2004,53,Washington,Black,412,371,591,533,196,395,169,364,.33164129,.31707317,,,0,0
2004,53,Washington,Hispanic,588,555,814,767,435,379,406,361,.53439802,.52933508,,,0,0
2004,53,Washington,Total,20292,17959,31815,28030,20110,11705,17421,10609,.63209176,.62151265,10729,7108,0,0
2004,53,Washington,White,14548,12775,22617,19761,14910,7707,12838,6923,.65923864,.64966351,,,0,0
2004,54,West Virginia,Asian,153,132,322,278,222,100,197,81,.68944097,.70863307,,,0,0
2004,54,West Virginia,Black,46,42,63,56,21,42,18,38,.33333334,.32142857,,,0,0
2004,54,West Virginia,Hispanic,9,8,14,13,7,7,6,7,.5,.46153846,,,0,0
2004,54,West Virginia,Total,3135,2920,4750,4404,2370,2380,2159,2245,.49894738,.49023616,2170,1110,0,0
2004,54,West Virginia,White,2791,2618,4147,3875,2000,2147,1832,2043,.48227635,.47277421,,,0,0
2004,55,Wisconsin,Asian,755,680,1390,1234,986,404,864,370,.70935249,.70016205,,,0,0
2004,55,Wisconsin,Black,367,334,506,463,148,358,116,347,.29249012,.25053996,,,0,0
2004,55,Wisconsin,Hispanic,271,227,387,324,232,155,192,132,.59948319,.5925926,,,0,0
2004,55,Wisconsin,Total,19906,17941,31404,28245,21684,9720,19344,8901,.6904853,.68486458,12048,8601,0,0
2004,55,Wisconsin,White,17660,15960,27796,25095,19408,8388,17405,7690,.69822997,.69356447,,,0,0
2004,56,Wyoming,Asian,23,23,37,37,17,20,17,20,.45945945,.45945945,,,0,0
2004,56,Wyoming,Black,3,3,5,5,2,3,2,3,.40000001,.40000001,,,0,0
2004,56,Wyoming,Hispanic,19,19,25,25,17,8,17,8,.68000001,.68000001,,,0,0
2004,56,Wyoming,Total,799,799,1174,1174,633,541,633,541,.53918231,.53918231,638,391,0,0
2004,56,Wyoming,White,693,693,1013,1013,554,459,554,459,.54689044,.54689044,,,0,0
2005,1,Alabama,Asian,406,326,921,750,698,223,565,185,.75787187,.75333333,,,0,0
2005,1,Alabama,Black,756,713,1017,955,239,778,216,739,.23500492,.22617801,,,0,0
2005,1,Alabama,Hispanic,38,32,65,57,43,22,38,19,.66153848,.66666669,,,0,0
2005,1,Alabama,Total,7213,5533,11909,9139,6966,4943,5207,3932,.58493578,.56975597,3597,1985,0,0
2005,1,Alabama,White,5691,4197,9380,6941,5653,3727,4115,2826,.60266525,.59285408,,,0,0
2005,2,Alaska,Asian,196,192,368,362,212,156,210,152,.57608694,.58011049,,,0,0
2005,2,Alaska,Black,30,30,42,42,21,21,21,21,.5,.5,,,0,0
2005,2,Alaska,Hispanic,34,32,57,55,40,17,39,16,.70175439,.70909089,,,0,0
2005,2,Alaska,Total,2208,2112,3687,3566,2377,1310,2310,1256,.64469761,.64778465,1375,857,0,0
2005,2,Alaska,White,1716,1643,2860,2765,1910,950,1855,910,.6678322,.6708861,,,0,0
2005,4,Arizona,Asian,1121,1003,2324,2066,1554,770,1364,702,.66867471,.66021299,,,0,0
2005,4,Arizona,Black,249,225,387,347,156,231,129,218,.40310079,.37175792,,,0,0
2005,4,Arizona,Hispanic,1583,1446,2297,2070,1096,1201,945,1125,.47714409,.45652175,,,0,0
2005,4,Arizona,Total,13642,11790,23087,19672,13838,9249,11592,8080,.59938496,.58926392,7255,5474,0,0
2005,4,Arizona,White,9175,7818,15751,13248,9794,5957,8147,5101,.62180179,.61496073,,,0,0
2005,5,Arkansas,Asian,408,390,918,881,373,545,355,526,.40631807,.40295118,,,1,1
2005,5,Arkansas,Black,1878,1866,2963,2947,166,2797,160,2787,.056024298,.0542925,,,1,1
2005,5,Arkansas,Hispanic,214,212,367,363,103,264,103,260,.28065395,.28374657,,,1,1
2005,5,Arkansas,Total,13883,13267,23140,22080,6524,16616,6012,16068,.28193605,.2722826,6393,2050,1,1
2005,5,Arkansas,White,10610,10069,17559,16632,5468,12091,5009,11623,.31140727,.30116642,,,1,1
2005,6,California,Asian,51522,46181,104817,94057,62728,42089,55576,38481,.59845257,.59087574,,,0,0
2005,6,California,Black,6646,5767,10866,9383,3402,7464,2711,6672,.31308669,.28892678,,,0,0
2005,6,California,Hispanic,39199,36153,62421,57680,28455,33966,25678,32002,.4558562,.4451803,,,0,0
2005,6,California,Total,211171,182610,381015,328475,220245,160770,184214,144261,.57804811,.56081587,103580,69978,0,0
2005,6,California,White,77582,63550,141142,115024,92060,49082,72981,42043,.65225095,.63448501,,,0,0
2005,8,Colorado,Asian,1209,1136,2262,2122,1331,931,1238,884,.58841735,.58341187,,,0,0
2005,8,Colorado,Black,550,515,861,803,283,578,253,550,.32868758,.31506848,,,0,0
2005,8,Colorado,Hispanic,1125,1075,1673,1598,763,910,718,880,.45606694,.44931164,,,0,0
2005,8,Colorado,Total,20453,18863,33764,31114,21017,12747,19171,11943,.6224677,.61615348,11602,7526,0,0
2005,8,Colorado,White,15677,14386,25947,23810,16883,9064,15368,8442,.6506725,.64544308,,,0,0
2005,9,Connecticut,Asian,1387,937,2878,1889,2149,729,1405,484,.74669909,.74377978,,,0,0
2005,9,Connecticut,Black,752,579,1110,821,394,716,213,608,.35495496,.25943971,,,0,0
2005,9,Connecticut,Hispanic,420,370,596,515,314,282,250,265,.52684563,.48543689,,,0,0
2005,9,Connecticut,Total,18733,14243,32380,23818,23533,8847,17102,6716,.72677577,.71802837,8932,6783,0,0
2005,9,Connecticut,White,14318,10946,24698,18338,18506,6192,13714,4624,.74929142,.74784601,,,0,0
2005,10,Delaware,Asian,368,293,802,627,506,296,371,256,.63092268,.59170651,,,0,0
2005,10,Delaware,Black,318,293,492,447,148,344,119,328,.30081302,.26621923,,,0,0
2005,10,Delaware,Hispanic,47,41,78,66,37,41,28,38,.47435898,.42424244,,,0,0
2005,10,Delaware,Total,4086,2944,7317,5214,4240,3077,2544,2670,.57947248,.48791716,1660,894,0,0
2005,10,Delaware,White,3026,2073,5363,3634,3247,2116,1839,1795,.60544473,.50605392,,,0,0
2005,11,District Of Columbia,Asian,161,64,312,109,204,108,37,72,.65384614,.33944955,,,0,0
2005,11,District Of Columbia,Black,729,518,1055,728,233,822,68,660,.22085308,.093406595,,,0,0
2005,11,District Of Columbia,Hispanic,30,8,55,11,34,21,3,8,.61818182,.27272728,,,0,0
2005,11,District Of Columbia,Total,2818,984,5199,1665,3378,1821,553,1112,.64974034,.33213213,642,242,0,0
2005,11,District Of Columbia,White,1387,169,2913,459,2375,538,315,144,.81531066,.68627453,,,0,0
2005,12,Florida,Asian,5496,5015,12178,11071,6456,5722,5761,5310,.53013629,.52036852,,,0,1
2005,12,Florida,Black,7527,7176,12130,11518,3285,8845,3034,8484,.27081615,.26341379,,,0,1
2005,12,Florida,Hispanic,3351,3054,5396,4876,2414,2982,2088,2788,.44736841,.42821985,,,0,1
2005,12,Florida,Total,88440,77460,160584,139505,79809,80775,66174,73331,.49699223,.47434857,41074,24664,0,1
2005,12,Florida,White,50099,43622,92541,80041,48303,44238,40135,39906,.52196324,.50143051,,,0,1
2005,13,Georgia,Asian,3335,3071,6589,6013,4261,2328,3801,2212,.64668387,.63213038,,,0,0
2005,13,Georgia,Black,5905,5710,8286,7972,2076,6210,1907,6065,.25054309,.23921224,,,0,0
2005,13,Georgia,Hispanic,512,457,773,682,385,388,311,371,.49805951,.45601174,,,0,0
2005,13,Georgia,Total,36358,31236,58352,49258,33618,24734,26843,22415,.57612419,.54494703,17272,9563,0,0
2005,13,Georgia,White,23821,19567,38259,30786,24338,13921,18780,12006,.6361379,.61001754,,,0,0
2005,15,Hawaii,Asian,2842,1504,4656,2191,2937,1719,1059,1132,.630799,.48334095,,,0,0
2005,15,Hawaii,Black,41,35,65,50,39,26,28,22,.60000002,.56,,,0,0
2005,15,Hawaii,Hispanic,50,31,77,44,41,36,22,22,.53246754,.5,,,0,0
2005,15,Hawaii,Total,4321,2243,7058,3250,4499,2559,1588,1662,.63743269,.48861539,1667,887,0,0
2005,15,Hawaii,White,838,437,1371,637,901,470,344,293,.65718454,.54003137,,,0,0
2005,16,Idaho,Asian,136,131,261,255,167,94,163,92,.63984674,.63921571,,,0,0
2005,16,Idaho,Black,16,15,28,26,15,13,15,11,.53571427,.57692307,,,0,0
2005,16,Idaho,Hispanic,77,74,127,123,50,77,49,74,.39370078,.39837399,,,0,0
2005,16,Idaho,Total,3488,3338,5599,5373,3500,2099,3346,2027,.62511164,.62274337,2226,1514,0,0
2005,16,Idaho,White,3033,2905,4822,4630,3059,1763,2921,1709,.6343841,.63088554,,,0,0
2005,17,Illinois,Asian,5310,4894,10992,10225,8153,2839,7606,2619,.74172127,.74386311,,,0,0
2005,17,Illinois,Black,2857,2517,4116,3568,1263,2853,999,2569,.3068513,.2799888,,,0,0
2005,17,Illinois,Hispanic,3218,2657,4759,3978,2253,2506,1811,2167,.47341877,.4552539,,,0,0
2005,17,Illinois,Total,45188,38207,79257,67456,55844,23413,47713,19743,.7045939,.70732033,23625,17430,0,0
2005,17,Illinois,White,30147,25065,53318,44557,40170,13148,33935,10622,.75340408,.76160872,,,0,0
2005,18,Indiana,Asian,844,722,1806,1531,1227,579,1015,516,.67940199,.66296536,,,0,0
2005,18,Indiana,Black,594,534,926,808,270,656,193,615,.29157668,.23886138,,,0,0
2005,18,Indiana,Hispanic,263,232,416,369,152,264,119,250,.36538461,.32249323,,,0,0
2005,18,Indiana,Total,17898,15534,28821,24563,14667,14154,11871,12692,.50889975,.48328787,10255,4935,0,0
2005,18,Indiana,White,15351,13348,24307,20785,12305,12002,10027,10758,.5062328,.4824152,,,0,0
2005,19,Iowa,Asian,311,289,560,521,423,137,395,126,.75535715,.75815737,,,0,0
2005,19,Iowa,Black,69,65,96,91,41,55,38,53,.42708334,.41758242,,,0,0
2005,19,Iowa,Hispanic,83,76,99,92,49,50,44,48,.49494949,.47826087,,,0,0
2005,19,Iowa,Total,6047,5448,8986,8145,6040,2946,5516,2629,.67215669,.67722529,3281,2248,0,0
2005,19,Iowa,White,5233,4712,7675,6962,5152,2523,4713,2249,.67127037,.67696065,,,0,0
2005,20,Kansas,Asian,390,361,695,644,438,257,410,234,.63021582,.63664597,,,0,0
2005,20,Kansas,Black,140,137,181,178,68,113,67,111,.37569061,.37640449,,,0,0
2005,20,Kansas,Hispanic,141,130,192,177,95,97,84,93,.49479166,.47457626,,,0,0
2005,20,Kansas,Total,5301,4920,7959,7387,5147,2812,4767,2620,.6466893,.64532286,2843,1973,0,0
2005,20,Kansas,White,4289,3977,6399,5937,4251,2148,3935,2002,.66432256,.66279268,,,0,0
2005,21,Kentucky,Asian,488,432,1001,871,641,360,554,317,.64035964,.63605052,,,0,0
2005,21,Kentucky,Black,435,409,628,586,173,455,155,431,.27547771,.26450512,,,0,0
2005,21,Kentucky,Hispanic,87,77,129,116,71,58,68,48,.55038762,.58620691,,,0,0
2005,21,Kentucky,Total,12340,10246,19747,15997,9704,10043,7319,8678,.49141642,.45752329,6111,3187,0,0
2005,21,Kentucky,White,10724,8826,16996,13620,8296,8700,6149,7471,.48811486,.45146844,,,0,0
2005,22,Louisiana,Asian,318,220,578,404,387,191,268,136,.66955018,.66336632,,,0,0
2005,22,Louisiana,Black,503,386,659,508,197,462,143,365,.2989378,.28149608,,,0,0
2005,22,Louisiana,Hispanic,41,26,61,40,34,27,18,22,.55737704,.44999999,,,0,0
2005,22,Louisiana,Total,4648,2474,7050,3656,4140,2910,1858,1798,.58723402,.50820571,1636,900,0,0
2005,22,Louisiana,White,3428,1663,5201,2440,3166,2035,1280,1160,.60872906,.52459013,,,0,0
2005,23,Maine,Asian,184,119,299,192,158,141,107,85,.52842808,.55729169,,,0,0
2005,23,Maine,Black,29,14,44,20,19,25,10,10,.43181819,.5,,,0,0
2005,23,Maine,Hispanic,11,6,13,8,9,4,6,2,.69230771,.75,,,0,0
2005,23,Maine,Total,5329,4292,8113,6372,4937,3176,3853,2519,.60852951,.60467672,2846,1883,0,0
2005,23,Maine,White,4845,3943,7372,5851,4533,2839,3564,2287,.61489421,.60912663,,,0,0
2005,24,Maryland,Asian,4293,3931,9370,8642,6741,2629,6248,2394,.71942371,.7229808,,,0,0
2005,24,Maryland,Black,4130,3713,6353,5693,2188,4165,1843,3850,.34440422,.32373089,,,0,0
2005,24,Maryland,Hispanic,374,315,661,560,406,255,332,228,.61422086,.59285712,,,0,0
2005,24,Maryland,Total,37357,31537,68533,58320,45234,23299,37963,20357,.66003239,.6509431,17186,11376,0,0
2005,24,Maryland,White,24461,20046,44946,37240,31157,13789,25540,11700,.69320965,.68582171,,,0,0
2005,25,Massachusetts,Asian,2913,2209,5808,4327,4342,1466,3163,1164,.74758953,.73099142,,,0,0
2005,25,Massachusetts,Black,877,654,1286,926,542,744,316,610,.42146191,.34125271,,,0,0
2005,25,Massachusetts,Hispanic,324,279,450,385,233,217,192,193,.5177778,.4987013,,,0,0
2005,25,Massachusetts,Total,30704,23162,52108,38495,37505,14603,26848,11647,.71975511,.69744122,15293,11157,0,0
2005,25,Massachusetts,White,23507,17701,39421,29108,28806,10615,20718,8390,.73072726,.71176308,,,0,0
2005,26,Michigan,Asian,2148,1876,4466,3914,3379,1087,2969,945,.75660545,.75855905,,,0,0
2005,26,Michigan,Black,1177,1069,1651,1481,595,1056,490,991,.36038765,.33085752,,,0,0
2005,26,Michigan,Hispanic,420,366,610,518,326,284,277,241,.53442621,.53474903,,,0,0
2005,26,Michigan,Total,30099,25803,48312,41150,31620,16692,26703,14447,.65449578,.64891857,17810,11784,0,0
2005,26,Michigan,White,24296,20728,38318,32479,25305,13013,21274,11205,.66039461,.65500784,,,0,0
2005,27,Minnesota,Asian,1245,1095,2223,1948,1312,911,1120,828,.59019345,.57494867,,,0,0
2005,27,Minnesota,Black,285,246,411,353,137,274,103,250,.33333334,.2917847,,,0,0
2005,27,Minnesota,Hispanic,147,122,228,185,128,100,104,81,.56140351,.56216216,,,0,0
2005,27,Minnesota,Total,18902,16409,29480,25405,19679,9801,16826,8579,.66753733,.66231054,10145,6715,0,0
2005,27,Minnesota,White,16193,14091,25018,21608,17076,7942,14673,6935,.68254858,.67905408,,,0,0
2005,28,Mississippi,Asian,108,79,192,145,107,85,83,62,.55729169,.5724138,,,0,0
2005,28,Mississippi,Black,958,922,1461,1410,155,1306,139,1271,.10609172,.09858156,,,0,0
2005,28,Mississippi,Hispanic,20,15,22,17,8,14,7,10,.36363637,.41176471,,,0,0
2005,28,Mississippi,Total,3937,3109,5910,4581,2211,3699,1483,3098,.37411168,.32372844,1937,776,0,0
2005,28,Mississippi,White,2629,1919,3892,2750,1813,2079,1183,1567,.46582735,.43018183,,,0,0
2005,29,Missouri,Asian,577,467,1316,1057,1038,278,815,242,.78875381,.77105016,,,0,0
2005,29,Missouri,Black,392,302,572,435,264,308,176,259,.46153846,.4045977,,,0,0
2005,29,Missouri,Hispanic,89,70,151,110,102,49,71,39,.6754967,.64545453,,,0,0
2005,29,Missouri,Total,10467,7604,18407,13108,12892,5515,8727,4381,.70038575,.66577661,5023,3470,0,0
2005,29,Missouri,White,8802,6330,15257,10746,10690,4567,7146,3600,.70066202,.66499162,,,0,0
2005,30,Montana,Asian,36,35,61,60,46,15,45,15,.75409836,.75,,,0,0
2005,30,Montana,Black,2,2,2,2,1,1,1,1,.5,.5,,,0,0
2005,30,Montana,Hispanic,14,14,20,20,13,7,13,7,.64999998,.64999998,,,0,0
2005,30,Montana,Total,2189,2039,3250,3077,2115,1135,2016,1061,.65076923,.65518361,1550,1034,0,0
2005,30,Montana,White,2017,1876,2989,2829,1952,1037,1857,972,.65306121,.6564157,,,0,0
2005,31,Nebraska,Asian,124,108,198,173,119,79,103,70,.60101008,.59537572,,,0,0
2005,31,Nebraska,Black,53,46,77,66,37,40,28,38,.48051947,.42424244,,,0,0
2005,31,Nebraska,Hispanic,58,52,79,71,31,48,27,44,.39240506,.38028169,,,0,0
2005,31,Nebraska,Total,2622,2163,3920,3193,2356,1564,1865,1328,.6010204,.58409017,1395,877,0,0
2005,31,Nebraska,White,2214,1816,3313,2678,2012,1301,1585,1093,.60730457,.59185958,,,0,0
2005,32,Nevada,Asian,911,836,1903,1744,905,998,835,909,.4755649,.47878441,,,0,0
2005,32,Nevada,Black,192,185,304,293,87,217,83,210,.28618422,.28327644,,,0,0
2005,32,Nevada,Hispanic,448,437,722,700,336,386,328,372,.46537396,.46857142,,,0,0
2005,32,Nevada,Total,6363,5917,11568,10667,5970,5598,5468,5199,.51607883,.512609,3579,1889,0,0
2005,32,Nevada,White,4066,3775,7298,6736,3983,3315,3650,3086,.54576594,.54186463,,,0,0
2005,33,New Hampshire,Asian,299,104,550,145,420,130,101,44,.76363635,.69655174,,,0,0
2005,33,New Hampshire,Black,37,5,52,7,32,20,5,2,.61538464,.71428573,,,0,0
2005,33,New Hampshire,Hispanic,23,13,40,19,27,13,12,7,.67500001,.63157892,,,0,0
2005,33,New Hampshire,Total,4430,2929,6686,4136,4543,2143,2589,1547,.67947948,.62596714,2311,1584,0,0
2005,33,New Hampshire,White,3761,2640,5546,3708,3701,1845,2297,1411,.66732782,.61947143,,,0,0
2005,34,New Jersey,Asian,5999,5299,12242,10794,9357,2885,8330,2464,.76433587,.77172506,,,0,0
2005,34,New Jersey,Black,1570,1290,2390,1933,930,1460,680,1253,.38912135,.3517848,,,0,0
2005,34,New Jersey,Hispanic,705,586,1063,856,553,510,424,432,.52022576,.49532712,,,0,0
2005,34,New Jersey,Total,36215,29215,64682,51905,45756,18926,36850,15055,.70739925,.70995086,19229,14273,0,0
2005,34,New Jersey,White,23049,18118,41025,32027,29705,11320,23335,8692,.72407067,.72860402,,,0,0
2005,35,New Mexico,Asian,207,167,388,311,242,146,185,126,.62371135,.59485531,,,0,0
2005,35,New Mexico,Black,79,70,123,109,37,86,31,78,.30081302,.28440368,,,0,0
2005,35,New Mexico,Hispanic,1169,1060,1723,1565,627,1096,527,1038,.36390018,.33674121,,,0,0
2005,35,New Mexico,Total,5991,5230,9505,8289,4283,5222,3467,4822,.45060495,.41826516,3184,1475,0,0
2005,35,New Mexico,White,2842,2476,4741,4126,2502,2239,2045,2081,.52773678,.49563742,,,0,0
2005,36,New York,Asian,11189,10168,21025,19243,14096,6929,12924,6319,.67043996,.67162085,,,0,0
2005,36,New York,Black,5710,4831,8270,6984,2740,5530,2125,4859,.33131802,.3042669,,,0,0
2005,36,New York,Hispanic,2501,1968,3587,2848,1668,1919,1312,1536,.46501255,.46067417,,,0,0
2005,36,New York,Total,99034,83565,167032,141856,105322,61710,88788,53068,.63054985,.6259023,49770,34930,0,0
2005,36,New York,White,65199,54675,111557,94115,73695,37862,61819,32296,.660604,.65684533,,,0,0
2005,37,North Carolina,Asian,1974,1750,4379,3886,2698,1681,2274,1612,.61612242,.58517754,,,0,0
2005,37,North Carolina,Black,4057,3952,6797,6620,1542,5255,1436,5184,.2268648,.21691842,,,0,0
2005,37,North Carolina,Hispanic,365,343,635,589,313,322,280,309,.4929134,.475382,,,0,0
2005,37,North Carolina,Total,38194,34048,70026,62051,39012,31014,33249,28802,.55710739,.53583342,19931,12827,0,0
2005,37,North Carolina,White,29276,25754,53691,46959,32021,21670,27199,19760,.59639418,.57920742,,,0,0
2005,38,North Dakota,Asian,46,46,95,95,77,18,77,18,.81052631,.81052631,,,0,0
2005,38,North Dakota,Black,3,3,5,5,4,1,4,1,.80000001,.80000001,,,0,0
2005,38,North Dakota,Hispanic,4,4,5,5,3,2,3,2,.60000002,.60000002,,,0,0
2005,38,North Dakota,Total,993,964,1422,1393,970,452,947,446,.68213785,.67982769,669,453,0,0
2005,38,North Dakota,White,906,878,1268,1240,855,413,833,407,.67429024,.67177421,,,0,0
2005,39,Ohio,Asian,1761,1453,3678,3035,2787,891,2268,767,.75774878,.74728173,,,0,0
2005,39,Ohio,Black,1639,1424,2292,1983,724,1568,535,1448,.31588131,.26979324,,,0,0
2005,39,Ohio,Hispanic,276,207,441,325,241,200,165,160,.54648525,.50769234,,,0,0
2005,39,Ohio,Total,34413,27212,55702,43754,36234,19468,27536,16218,.65049732,.62933677,17935,11787,0,0
2005,39,Ohio,White,28628,22504,45898,35825,30286,15612,22961,12864,.65985447,.64092112,,,0,0
2005,40,Oklahoma,Asian,671,593,1382,1210,743,639,604,606,.53762662,.49917355,,,0,0
2005,40,Oklahoma,Black,597,570,913,872,210,703,188,684,.23001096,.21559633,,,0,0
2005,40,Oklahoma,Hispanic,363,343,519,483,211,308,190,293,.40655106,.39337474,,,0,0
2005,40,Oklahoma,Total,11353,10234,19138,17043,9146,9992,7682,9361,.47789738,.45074224,6344,2971,0,0
2005,40,Oklahoma,White,8017,7202,13561,12045,6767,6794,5707,6338,.49900451,.47380656,,,0,0
2005,41,Oregon,Asian,830,719,1400,1227,871,529,743,484,.62214285,.60554194,,,0,0
2005,41,Oregon,Black,67,63,86,82,29,57,26,56,.33720931,.31707317,,,0,0
2005,41,Oregon,Hispanic,212,200,287,265,158,129,141,124,.55052263,.53207546,,,0,0
2005,41,Oregon,Total,8365,7342,12452,10810,7917,4535,6738,4072,.63580149,.62331176,5066,3488,0,0
2005,41,Oregon,White,6597,5784,9758,8449,6318,3440,5379,3070,.64746875,.63664341,,,0,0
2005,42,Pennsylvania,Asian,2529,2013,4851,3933,3514,1337,2877,1056,.72438675,.73150265,,,0,0
2005,42,Pennsylvania,Black,1291,1088,1772,1477,465,1307,329,1148,.26241535,.22274882,,,0,0
2005,42,Pennsylvania,Hispanic,356,287,532,419,290,242,216,203,.54511279,.51551312,,,0,0
2005,42,Pennsylvania,Total,37216,28622,60736,46222,40939,19797,31121,15101,.67404836,.67329413,19004,13100,0,0
2005,42,Pennsylvania,White,30598,23409,49557,37452,33863,15694,25684,11768,.68331414,.68578446,,,0,0
2005,44,Rhode Island,Asian,142,91,255,154,173,82,101,53,.67843139,.65584415,,,0,0
2005,44,Rhode Island,Black,76,44,116,64,57,59,29,35,.49137932,.453125,,,0,0
2005,44,Rhode Island,Hispanic,27,16,39,25,21,18,14,11,.53846157,.56,,,0,0
2005,44,Rhode Island,Total,3081,1837,5113,2814,3251,1862,1645,1169,.63583022,.58457714,1203,800,0,0
2005,44,Rhode Island,White,2499,1503,4153,2287,2651,1502,1326,961,.63833374,.57979888,,,0,0
2005,45,South Carolina,Asian,526,488,1114,1047,730,384,691,356,.65529621,.65998089,,,1,1
2005,45,South Carolina,Black,1730,1700,2496,2442,685,1811,660,1782,.2744391,.27027026,,,1,1
2005,45,South Carolina,Hispanic,96,88,162,149,96,66,84,65,.5925926,.56375837,,,1,1
2005,45,South Carolina,Total,13666,12301,22850,20460,12693,10157,11065,9395,.55549234,.54081136,7334,4213,1,1
2005,45,South Carolina,White,10508,9286,17728,15603,10447,7281,8984,6619,.58929378,.57578671,,,1,1
2005,46,South Dakota,Asian,57,56,119,115,80,39,76,39,.67226893,.66086954,,,0,0
2005,46,South Dakota,Black,15,14,26,24,10,16,10,14,.38461539,.41666666,,,0,0
2005,46,South Dakota,Hispanic,13,11,17,15,6,11,5,10,.35294119,.33333334,,,0,0
2005,46,South Dakota,Total,1857,1740,3085,2920,1907,1178,1825,1095,.61815232,.625,1201,755,0,0
2005,46,South Dakota,White,1685,1578,2782,2632,1735,1047,1661,971,.62365204,.63107902,,,0,0
2005,47,Tennessee,Asian,827,660,1656,1320,1129,527,893,427,.68176329,.67651516,,,0,0
2005,47,Tennessee,Black,1369,1234,1955,1734,641,1314,549,1185,.32787722,.316609,,,0,0
2005,47,Tennessee,Hispanic,133,101,211,156,132,79,92,64,.62559241,.58974361,,,0,0
2005,47,Tennessee,Total,14179,10368,23243,16432,14786,8457,9711,6721,.63614851,.59098101,6306,4269,0,0
2005,47,Tennessee,White,11119,7893,18212,12465,12099,6113,7730,4735,.66434216,.62013638,,,0,0
2005,48,Texas,Asian,10007,9458,23190,22009,14180,9010,13310,8699,.61147046,.6047526,,,0,0
2005,48,Texas,Black,6826,6594,11283,10901,2647,8636,2425,8476,.23460072,.22245665,,,0,0
2005,48,Texas,Hispanic,24887,24072,40032,38768,13695,26337,12932,25836,.34210131,.33357409,,,0,0
2005,48,Texas,Total,112263,104688,204403,190672,99428,104975,89796,100876,.48643121,.47094488,58664,32841,0,0
2005,48,Texas,White,54706,49625,103783,94447,57443,46340,50775,43672,.55349141,.53760308,,,0,0
2005,49,Utah,Asian,700,621,1285,1138,766,519,698,440,.59610897,.61335677,,,0,0
2005,49,Utah,Black,61,47,85,68,43,42,37,31,.50588238,.54411763,,,0,0
2005,49,Utah,Hispanic,297,244,434,365,247,187,213,152,.5691244,.58356166,,,0,0
2005,49,Utah,Total,14937,14026,24528,23016,16059,8469,15174,7842,.65472114,.65928048,8584,6202,0,0
2005,49,Utah,White,12709,12041,20868,19754,13895,6973,13204,6550,.66585201,.66842157,,,0,0
2005,50,Vermont,Asian,89,58,139,92,92,47,63,29,.66187048,.68478262,,,0,0
2005,50,Vermont,Black,15,11,18,14,10,8,7,7,.55555558,.5,,,0,0
2005,50,Vermont,Hispanic,10,7,16,12,9,7,6,6,.5625,.5,,,0,0
2005,50,Vermont,Total,2524,2073,3914,3155,2625,1289,2064,1091,.67066938,.65419966,1498,1101,0,0
2005,50,Vermont,White,2258,1876,3511,2857,2367,1144,1874,983,.67416692,.65593278,,,0,0
2005,51,Virginia,Asian,4846,4524,10131,9437,6044,4087,5614,3823,.59658474,.59489244,,,0,0
2005,51,Virginia,Black,3526,3332,5482,5126,1876,3606,1688,3438,.34221086,.3293016,,,0,0
2005,51,Virginia,Hispanic,541,510,948,896,523,425,494,402,.55168778,.55133927,,,0,0
2005,51,Virginia,Total,44560,39660,80583,70970,49728,30855,43072,27898,.61710286,.60690433,21700,14218,0,0
2005,51,Virginia,White,30755,26897,55602,48031,36385,19217,31020,17011,.65438294,.6458329,,,0,0
2005,53,Washington,Asian,3354,3060,5752,5261,3313,2439,2987,2274,.57597357,.56776279,,,0,0
2005,53,Washington,Black,464,405,670,585,233,437,194,391,.34776118,.33162394,,,0,0
2005,53,Washington,Hispanic,709,680,991,946,447,544,423,523,.45105955,.44714588,,,0,0
2005,53,Washington,Total,22573,20001,35704,31531,22112,13592,19159,12372,.61931437,.60762423,12569,8064,0,0
2005,53,Washington,White,15911,13976,24971,21841,16141,8830,13865,7976,.64638978,.63481528,,,0,0
2005,54,West Virginia,Asian,132,110,289,250,203,86,180,70,.70242214,.72000003,,,0,0
2005,54,West Virginia,Black,47,44,65,61,18,47,16,45,.27692309,.26229507,,,0,0
2005,54,West Virginia,Hispanic,11,11,15,15,9,6,9,6,.60000002,.60000002,,,0,0
2005,54,West Virginia,Total,3235,3033,4840,4505,2279,2561,2076,2429,.47086778,.4608213,2008,994,0,0
2005,54,West Virginia,White,2884,2726,4210,3958,1900,2310,1746,2212,.4513064,.44113189,,,0,0
2005,55,Wisconsin,Asian,817,725,1486,1320,965,521,848,472,.64939433,.64242423,,,0,0
2005,55,Wisconsin,Black,427,376,579,508,154,425,115,393,.26597583,.22637795,,,0,0
2005,55,Wisconsin,Hispanic,307,268,432,379,207,225,172,207,.47916666,.45382586,,,0,0
2005,55,Wisconsin,Total,21221,19174,33524,30299,22621,10903,20308,9991,.6747703,.67025316,12878,9168,0,0
2005,55,Wisconsin,White,18638,16912,29397,26685,20224,9173,18274,8411,.68796134,.6848042,,,0,0
2005,56,Wyoming,Asian,26,26,42,42,19,23,19,23,.45238096,.45238096,,,0,0
2005,56,Wyoming,Black,6,6,9,9,4,5,4,5,.44444445,.44444445,,,0,0
2005,56,Wyoming,Hispanic,26,26,35,35,14,21,14,21,.40000001,.40000001,,,0,0
2005,56,Wyoming,Total,934,934,1365,1365,629,736,629,736,.46080586,.46080586,629,326,0,0
2005,56,Wyoming,White,828,828,1206,1206,556,650,556,650,.46102819,.46102819,,,0,0
2006,1,Alabama,Asian,384,308,793,637,591,202,476,161,.74527115,.74725276,,,0,0
2006,1,Alabama,Black,856,807,1112,1031,293,819,249,782,.26348922,.24151309,,,0,0
2006,1,Alabama,Hispanic,152,126,255,204,178,77,137,67,.69803923,.67156863,,,0,0
2006,1,Alabama,Total,7774,6011,12728,9799,7828,4900,5844,3955,.615022,.59638739,3597,2129,0,0
2006,1,Alabama,White,5988,4483,9810,7379,6286,3524,4635,2744,.64077473,.62813389,,,0,0
2006,2,Alaska,Asian,227,224,414,411,214,200,214,197,.51690823,.52068126,,,0,0
2006,2,Alaska,Black,56,56,87,87,18,69,18,69,.20689656,.20689656,,,0,0
2006,2,Alaska,Hispanic,97,90,150,142,83,67,80,62,.55333334,.5633803,,,0,0
2006,2,Alaska,Total,2402,2304,4100,3970,2470,1630,2404,1566,.60243905,.60554159,1471,941,0,0
2006,2,Alaska,White,1785,1707,3052,2945,1958,1094,1902,1043,.64154655,.64584041,,,0,0
2006,4,Arizona,Asian,1296,1184,2603,2343,1696,907,1519,824,.6515559,.64831412,,,0,0
2006,4,Arizona,Black,353,317,599,537,272,327,246,291,.45409015,.45810056,,,0,0
2006,4,Arizona,Hispanic,2657,2389,3808,3349,1757,2051,1505,1844,.46139705,.44938788,,,0,0
2006,4,Arizona,Total,15946,13841,26791,22819,15789,11002,13338,9481,.58933973,.58451289,8099,4929,0,0
2006,4,Arizona,White,10367,8853,17623,14796,10969,6654,9191,5605,.62242526,.62118143,,,0,0
2006,5,Arkansas,Asian,464,431,1061,1000,477,584,438,562,.44957587,.43799999,,,1,1
2006,5,Arkansas,Black,2069,2043,3348,3308,216,3132,209,3099,.064516127,.063180171,,,1,1
2006,5,Arkansas,Hispanic,494,487,753,745,275,478,272,473,.36520585,.36510068,,,1,1
2006,5,Arkansas,Total,15705,15120,25780,24847,7368,18412,6868,17979,.28580296,.27641165,8038,2652,1,1
2006,5,Arkansas,White,11949,11457,19403,18621,6027,13376,5598,13023,.31062207,.30062833,,,1,1
2006,6,California,Asian,54395,49208,111338,100667,68444,42894,61209,39458,.61474067,.60803443,,,0,0
2006,6,California,Black,7196,6384,11952,10464,3935,8017,3069,7395,.32923359,.29329127,,,0,0
2006,6,California,Hispanic,55923,51611,88397,81542,41650,46747,37296,44246,.47116983,.45738393,,,0,0
2006,6,California,Total,223619,194940,405711,352059,238420,167291,200850,151209,.58765972,.57050097,106040,71030,0,0
2006,6,California,White,80209,65840,144704,117847,95890,48814,76120,41727,.6626631,.64592224,,,0,0
2006,8,Colorado,Asian,1393,1330,2566,2446,1529,1037,1443,1003,.59586906,.58994275,,,0,0
2006,8,Colorado,Black,637,600,995,936,316,679,286,650,.31758794,.30555555,,,0,0
2006,8,Colorado,Hispanic,1928,1840,2798,2663,1333,1465,1248,1415,.47641173,.46864438,,,0,0
2006,8,Colorado,Total,22910,21274,38018,35172,23466,14552,21358,13814,.61723393,.60724437,12315,7753,0,0
2006,8,Colorado,White,17372,16077,28847,26622,18590,10257,16911,9711,.64443445,.63522649,,,0,0
2006,9,Connecticut,Asian,1517,1054,3162,2125,2480,682,1624,501,.78431374,.76423532,,,0,0
2006,9,Connecticut,Black,872,717,1314,1060,468,846,288,772,.3561644,.27169812,,,0,0
2006,9,Connecticut,Hispanic,1136,957,1761,1414,1111,650,848,566,.63089156,.59971714,,,0,0
2006,9,Connecticut,Total,19827,15187,34383,25305,25319,9064,18189,7116,.73638135,.71879077,9230,6809,0,0
2006,9,Connecticut,White,14775,11392,25243,18839,19188,6055,14206,4633,.76013154,.75407398,,,0,0
2006,10,Delaware,Asian,375,299,934,748,646,288,489,259,.69164884,.65374333,,,0,0
2006,10,Delaware,Black,369,341,574,532,160,414,136,396,.27874565,.25563911,,,0,0
2006,10,Delaware,Hispanic,159,132,282,238,141,141,105,133,.5,.44117647,,,0,0
2006,10,Delaware,Total,4494,3284,8220,6000,4747,3473,2943,3057,.57749391,.4905,1890,1017,0,0
2006,10,Delaware,White,3281,2277,5865,4063,3515,2350,2048,2015,.59931797,.50406104,,,0,0
2006,11,District Of Columbia,Asian,185,79,392,164,246,146,64,100,.62755102,.39024389,,,0,0
2006,11,District Of Columbia,Black,1005,741,1490,1064,299,1191,108,956,.20067114,.10150376,,,0,0
2006,11,District Of Columbia,Hispanic,290,175,477,255,236,241,75,180,.4947589,.29411766,,,0,0
2006,11,District Of Columbia,Total,3227,1255,5888,2032,3515,2373,564,1468,.59697688,.27755904,629,226,0,0
2006,11,District Of Columbia,White,1414,153,2902,350,2320,582,252,98,.79944867,.72000003,,,0,0
2006,12,Florida,Asian,6074,5635,13231,12236,6718,6513,6059,6177,.50774693,.49517816,,,0,1
2006,12,Florida,Black,9053,8788,14512,14077,3545,10967,3326,10751,.24428059,.23627193,,,0,1
2006,12,Florida,Hispanic,23204,20433,40054,35015,19243,20811,15830,19185,.48042643,.45209196,,,0,1
2006,12,Florida,Total,101648,90681,184933,163552,88152,96781,73970,89582,.47666994,.45227206,44940,24923,0,1
2006,12,Florida,White,55196,48778,100440,88117,50675,49765,42550,45567,.50453007,.48288071,,,0,1
2006,13,Georgia,Asian,3988,3712,7752,7168,4936,2816,4481,2687,.6367389,.62513953,,,0,0
2006,13,Georgia,Black,7258,6988,10065,9641,2452,7613,2244,7397,.24361649,.23275594,,,0,0
2006,13,Georgia,Hispanic,1678,1516,2574,2268,1401,1173,1162,1106,.54428905,.51234567,,,0,0
2006,13,Georgia,Total,43699,37968,70401,60306,39297,31104,32005,28301,.55818808,.53071004,19492,10786,0,0
2006,13,Georgia,White,27818,23105,44724,36547,27496,17228,21533,15014,.61479294,.58918655,,,0,0
2006,15,Hawaii,Asian,3077,1627,5099,2466,3106,1993,1112,1354,.60913903,.45093268,,,0,0
2006,15,Hawaii,Black,54,45,67,56,25,42,21,35,.37313432,.375,,,0,0
2006,15,Hawaii,Hispanic,117,61,177,87,99,78,36,51,.55932206,.41379312,,,0,0
2006,15,Hawaii,Total,4734,2464,7815,3679,4787,3028,1676,2003,.61254001,.45555857,1555,776,0,0
2006,15,Hawaii,White,876,425,1475,630,949,526,330,300,.64338982,.52380955,,,0,0
2006,16,Idaho,Asian,127,124,248,244,175,73,173,71,.70564514,.70901638,,,0,0
2006,16,Idaho,Black,16,15,22,21,11,11,10,11,.5,.47619048,,,0,0
2006,16,Idaho,Hispanic,151,146,246,238,107,139,103,135,.43495935,.43277311,,,0,0
2006,16,Idaho,Total,3919,3790,6152,5983,3886,2266,3769,2214,.63166451,.62995154,2470,1508,0,0
2006,16,Idaho,White,3389,3273,5247,5095,3369,1878,3262,1833,.6420812,.64023554,,,0,0
2006,17,Illinois,Asian,5710,5291,11776,10944,8792,2984,8231,2713,.74660325,.7521016,,,0,0
2006,17,Illinois,Black,3945,3546,5641,5016,1417,4224,1178,3838,.25119659,.23484848,,,0,0
2006,17,Illinois,Hispanic,5106,4442,7588,6664,3726,3862,3147,3517,.49103847,.4722389,,,0,0
2006,17,Illinois,Total,50835,43763,88801,76683,62011,26790,53530,23153,.69831419,.69806868,25673,18126,0,0
2006,17,Illinois,White,32764,27620,57527,48544,43789,13738,37211,11333,.76119041,.76654172,,,0,0
2006,18,Indiana,Asian,937,801,1936,1633,1311,625,1093,540,.67716944,.66932029,,,1,1
2006,18,Indiana,Black,669,619,935,858,231,704,198,660,.24705882,.23076923,,,1,1
2006,18,Indiana,Hispanic,427,352,661,541,273,388,218,323,.4130106,.4029575,,,1,1
2006,18,Indiana,Total,18517,16058,29807,25363,15705,14102,12921,12442,.52688968,.50944287,10908,5377,1,1
2006,18,Indiana,White,15588,13538,24603,21000,12989,11614,10721,10279,.52794373,.5105238,,,1,1
2006,19,Iowa,Asian,350,325,652,602,518,134,488,114,.79447854,.81063122,,,0,0
2006,19,Iowa,Black,81,79,112,107,64,48,61,46,.5714286,.57009345,,,0,0
2006,19,Iowa,Hispanic,120,115,174,166,98,76,90,76,.56321841,.54216868,,,0,0
2006,19,Iowa,Total,6607,6076,9833,9041,6859,2974,6290,2751,.69754905,.69571948,3714,2476,0,0
2006,19,Iowa,White,5730,5262,8398,7717,5814,2584,5320,2397,.69230771,.68938708,,,0,0
2006,20,Kansas,Asian,446,418,795,746,528,267,501,245,.66415095,.67158175,,,0,0
2006,20,Kansas,Black,161,154,217,209,68,149,66,143,.31336406,.31578946,,,0,0
2006,20,Kansas,Hispanic,225,205,292,266,151,141,132,134,.51712328,.49624062,,,0,0
2006,20,Kansas,Total,5903,5491,8842,8243,5770,3072,5353,2890,.65256727,.64939952,3419,2197,0,0
2006,20,Kansas,White,4772,4443,7047,6571,4694,2353,4350,2221,.66609907,.6619997,,,0,0
2006,21,Kentucky,Asian,539,479,1146,1013,743,403,656,357,.64834207,.64758146,,,0,0
2006,21,Kentucky,Black,459,441,714,681,205,509,191,490,.28711486,.28046989,,,0,0
2006,21,Kentucky,Hispanic,236,213,382,342,194,188,169,173,.50785339,.49415204,,,0,0
2006,21,Kentucky,Total,13625,11627,22349,18670,11477,10872,8966,9704,.51353526,.48023567,6595,3338,0,0
2006,21,Kentucky,White,11746,9912,18883,15548,9691,9192,7414,8134,.51321292,.47684589,,,0,0
2006,22,Louisiana,Asian,308,218,524,371,316,208,208,163,.60305345,.56064689,,,0,0
2006,22,Louisiana,Black,468,379,593,476,166,427,116,360,.27993256,.24369748,,,0,0
2006,22,Louisiana,Hispanic,178,98,272,149,170,102,84,65,.625,.56375837,,,0,0
2006,22,Louisiana,Total,4732,2686,6929,3797,3851,3078,1801,1996,.55578005,.47432184,1821,839,0,0
2006,22,Louisiana,White,3484,1804,5047,2473,2896,2151,1199,1274,.57380623,.48483622,,,0,0
2006,23,Maine,Asian,196,108,295,162,175,120,111,51,.59322035,.68518519,,,0,0
2006,23,Maine,Black,50,35,77,52,37,40,26,26,.48051947,.5,,,0,0
2006,23,Maine,Hispanic,74,52,92,65,52,40,37,28,.56521738,.56923079,,,0,0
2006,23,Maine,Total,5855,4648,8714,6776,5203,3511,4058,2718,.59708518,.59887838,3114,1925,0,0
2006,23,Maine,White,5227,4229,7749,6163,4667,3082,3711,2452,.60227126,.6021418,,,0,0
2006,24,Maryland,Asian,4695,4342,10263,9561,7317,2946,6824,2737,.71294945,.7137329,,,0,0
2006,24,Maryland,Black,4800,4345,7399,6695,2570,4829,2198,4497,.34734425,.32830471,,,0,0
2006,24,Maryland,Hispanic,2180,1949,3784,3344,2319,1465,2032,1312,.61284357,.60765553,,,0,0
2006,24,Maryland,Total,41711,35593,76774,65720,49852,26922,41926,23794,.64933443,.63794887,18174,12082,0,0
2006,24,Maryland,White,27031,22421,49618,41286,34025,15593,27869,13417,.68573904,.67502302,,,0,0
2006,25,Massachusetts,Asian,3164,2350,6276,4594,4830,1446,3422,1172,.76959848,.74488461,,,0,0
2006,25,Massachusetts,Black,1023,772,1542,1131,708,834,461,670,.45914397,.40760389,,,0,0
2006,25,Massachusetts,Hispanic,1422,1167,2075,1684,1152,923,868,816,.55518073,.51543945,,,0,0
2006,25,Massachusetts,Total,32948,24749,56084,41345,41160,14924,29454,11891,.73389918,.71239567,16049,11538,0,0
2006,25,Massachusetts,White,24822,18654,41720,30813,31168,10552,22515,8298,.74707574,.73069811,,,0,0
2006,26,Michigan,Asian,2247,1978,4562,4035,3497,1065,3098,937,.76654977,.76778191,,,0,0
2006,26,Michigan,Black,1332,1234,1979,1817,789,1190,676,1141,.3986862,.37204182,,,0,0
2006,26,Michigan,Hispanic,717,626,1094,941,670,424,557,384,.61243147,.59192348,,,0,0
2006,26,Michigan,Total,32571,28167,51795,44568,34438,17357,29286,15282,.66489041,.65710825,18326,12083,0,0
2006,26,Michigan,White,26075,22430,40452,34607,27108,13344,22958,11649,.67012757,.66339183,,,0,0
2006,27,Minnesota,Asian,1528,1377,2701,2426,1536,1165,1369,1057,.56867826,.5643034,,,0,0
2006,27,Minnesota,Black,401,349,559,485,188,371,158,327,.33631486,.32577321,,,0,0
2006,27,Minnesota,Hispanic,342,288,540,456,291,249,234,222,.53888887,.5131579,,,0,0
2006,27,Minnesota,Total,22469,19632,35821,31075,23220,12601,19960,11115,.6482231,.642317,10840,7135,0,0
2006,27,Minnesota,White,18812,16404,29534,25533,19588,9946,16807,8726,.6632356,.65824622,,,0,0
2006,28,Mississippi,Asian,144,112,241,185,118,123,82,103,.48962656,.44324324,,,0,0
2006,28,Mississippi,Black,1248,1205,1896,1826,193,1703,179,1647,.10179325,.098028481,,,0,0
2006,28,Mississippi,Hispanic,69,59,112,87,53,59,34,53,.4732143,.39080459,,,0,0
2006,28,Mississippi,Total,4613,3687,7065,5532,2413,4652,1628,3904,.34154281,.29428777,2378,798,0,0
2006,28,Mississippi,White,2926,2143,4445,3179,1898,2547,1254,1925,.42699662,.39446366,,,0,0
2006,29,Missouri,Asian,663,537,1452,1157,1124,328,883,274,.77410465,.76318061,,,0,0
2006,29,Missouri,Black,616,515,830,668,276,554,172,496,.33253011,.25748503,,,0,0
2006,29,Missouri,Hispanic,254,193,431,308,290,141,187,121,.67285383,.60714287,,,0,0
2006,29,Missouri,Total,11501,8417,19286,13633,13629,5657,9162,4471,.70667839,.67204577,5214,3396,0,0
2006,29,Missouri,White,9378,6733,15547,10767,11235,4312,7445,3322,.72264743,.69146466,,,0,0
2006,30,Montana,Asian,52,48,82,77,63,19,60,17,.76829267,.77922076,,,0,0
2006,30,Montana,Black,8,8,13,13,5,8,5,8,.38461539,.38461539,,,0,0
2006,30,Montana,Hispanic,36,36,46,46,27,19,27,19,.5869565,.5869565,,,0,0
2006,30,Montana,Total,2204,2055,3288,3104,2244,1044,2122,982,.68248177,.68363404,1531,1011,0,0
2006,30,Montana,White,1969,1832,2914,2745,1996,918,1884,861,.68496913,.68633878,,,0,0
2006,31,Nebraska,Asian,146,133,246,224,146,100,132,92,.59349591,.58928573,,,0,0
2006,31,Nebraska,Black,55,50,80,74,36,44,34,40,.44999999,.45945945,,,0,0
2006,31,Nebraska,Hispanic,130,117,174,158,106,68,96,62,.60919541,.60759491,,,0,0
2006,31,Nebraska,Total,3129,2754,4769,4219,2889,1880,2520,1699,.6057874,.59729797,1637,1018,0,0
2006,31,Nebraska,White,2604,2285,3943,3487,2417,1526,2112,1375,.61298501,.60567826,,,0,0
2006,32,Nevada,Asian,1068,993,2077,1923,899,1178,831,1092,.43283582,.43213728,,,0,0
2006,32,Nevada,Black,300,288,523,497,168,355,163,334,.32122371,.32796779,,,0,0
2006,32,Nevada,Hispanic,1008,982,1567,1522,679,888,660,862,.43331206,.43363994,,,0,0
2006,32,Nevada,Total,7299,6782,13005,11902,6461,6544,5897,6005,.49680892,.49546295,3907,2298,0,0
2006,32,Nevada,White,4325,4013,7660,7027,4156,3504,3809,3218,.54255873,.54205209,,,0,0
2006,33,New Hampshire,Asian,332,151,569,235,446,123,181,54,.7838313,.77021277,,,0,0
2006,33,New Hampshire,Black,46,14,70,21,48,22,14,7,.6857143,.66666669,,,0,0
2006,33,New Hampshire,Hispanic,85,51,133,73,97,36,46,27,.72932333,.63013697,,,0,0
2006,33,New Hampshire,Total,5034,3681,7559,5335,5355,2204,3669,1666,.70842701,.68772256,2582,1808,0,0
2006,33,New Hampshire,White,4214,3255,6161,4631,4307,1854,3164,1467,.6990748,.68322176,,,0,0
2006,34,New Jersey,Asian,6527,5853,13668,12235,10688,2980,9643,2592,.78197247,.78814876,,,0,0
2006,34,New Jersey,Black,1822,1513,2714,2234,1008,1706,742,1492,.37140751,.33213967,,,0,0
2006,34,New Jersey,Hispanic,3094,2630,4573,3835,2787,1786,2303,1532,.60944676,.6005215,,,0,0
2006,34,New Jersey,Total,39085,31632,69819,56351,50190,19629,40742,15609,.71885878,.72300404,20645,14740,0,0
2006,34,New Jersey,White,24443,19145,43033,33545,31568,11465,24882,8663,.73357654,.74174988,,,0,0
2006,35,New Mexico,Asian,240,191,471,377,295,176,224,153,.62632698,.59416443,,,0,0
2006,35,New Mexico,Black,117,108,195,177,67,128,58,119,.34358975,.32768363,,,0,0
2006,35,New Mexico,Hispanic,2166,1934,3130,2780,1145,1985,960,1820,.36581469,.34532374,,,0,0
2006,35,New Mexico,Total,6406,5549,10322,8891,4878,5444,3940,4951,.47258285,.44314474,3385,1623,0,0
2006,35,New Mexico,White,2964,2549,5019,4274,2762,2257,2199,2075,.55030882,.51450634,,,0,0
2006,36,New York,Asian,12162,11162,22998,21188,15626,7372,14366,6822,.67945039,.67802531,,,0,0
2006,36,New York,Black,6562,5704,9365,8108,3056,6309,2414,5694,.32632142,.29773062,,,0,0
2006,36,New York,Hispanic,10036,8413,14415,12071,7853,6562,6410,5661,.54477972,.53102475,,,0,0
2006,36,New York,Total,106373,90417,179181,152854,115827,63354,97553,55301,.64642459,.6382103,50944,33435,0,0
2006,36,New York,White,67822,56986,114923,96981,78456,36467,65567,31414,.68268317,.67608088,,,0,0
2006,37,North Carolina,Asian,2138,1983,4846,4480,2948,1898,2678,1802,.60833675,.59776783,,,0,0
2006,37,North Carolina,Black,4483,4386,7460,7290,1677,5783,1592,5698,.22479893,.21838135,,,0,0
2006,37,North Carolina,Hispanic,1360,1272,2374,2220,1228,1146,1117,1103,.51727045,.50315315,,,0,0
2006,37,North Carolina,Total,41038,36912,76578,68634,41938,34640,36341,32293,.54765075,.52948976,21197,12324,0,0
2006,37,North Carolina,White,30629,27050,57034,50194,33494,23540,28654,21540,.58726376,.57086504,,,0,0
2006,38,North Dakota,Asian,41,41,86,86,67,19,67,19,.77906978,.77906978,,,0,0
2006,38,North Dakota,Black,2,1,2,1,0,2,0,1,0,0,,,0,0
2006,38,North Dakota,Hispanic,11,11,13,13,10,3,10,3,.76923078,.76923078,,,0,0
2006,38,North Dakota,Total,1069,1022,1540,1489,1091,449,1053,436,.70844156,.70718604,724,517,0,0
2006,38,North Dakota,White,983,939,1390,1342,979,411,942,400,.70431656,.70193738,,,0,0
2006,39,Ohio,Asian,1941,1632,4088,3416,3154,934,2617,799,.7715264,.7661007,,,0,0
2006,39,Ohio,Black,1914,1710,2729,2425,852,1877,669,1756,.31220227,.27587628,,,0,0
2006,39,Ohio,Hispanic,635,498,969,762,624,345,463,299,.64396286,.60761154,,,0,0
2006,39,Ohio,Total,37260,29808,60275,47821,39832,20443,30572,17249,.66083783,.6393007,18526,11555,0,0
2006,39,Ohio,White,30464,24086,48315,37814,32368,15947,24579,13235,.6699369,.64999735,,,0,0
2006,40,Oklahoma,Asian,728,660,1493,1347,765,728,666,681,.51239115,.49443206,,,0,0
2006,40,Oklahoma,Black,629,613,916,887,232,684,216,671,.2532751,.24351747,,,0,0
2006,40,Oklahoma,Hispanic,667,622,1049,962,482,567,424,538,.45948523,.44074845,,,0,0
2006,40,Oklahoma,Total,12394,11358,20730,18835,9698,11032,8430,10405,.4678244,.44757101,6967,3339,0,0
2006,40,Oklahoma,White,8673,7901,14442,13053,7094,7348,6156,6897,.4912062,.47161573,,,0,0
2006,41,Oregon,Asian,971,835,1663,1439,1054,609,918,521,.63379437,.63794303,,,0,0
2006,41,Oregon,Black,90,80,130,113,53,77,42,71,.40769231,.37168142,,,0,0
2006,41,Oregon,Hispanic,460,430,635,590,356,279,325,265,.5606299,.55084747,,,0,0
2006,41,Oregon,Total,9667,8535,14505,12727,8984,5521,7711,5016,.61937261,.60587728,5199,3227,0,0
2006,41,Oregon,White,7507,6620,11041,9655,6871,4170,5855,3800,.62231684,.60642153,,,0,0
2006,42,Pennsylvania,Asian,2722,2215,5213,4286,3823,1390,3181,1105,.73335892,.74218386,,,0,0
2006,42,Pennsylvania,Black,1559,1324,2029,1695,591,1438,415,1280,.29127648,.24483776,,,0,0
2006,42,Pennsylvania,Hispanic,857,698,1282,1024,771,511,584,440,.60140407,.5703125,,,0,0
2006,42,Pennsylvania,Total,39517,30920,63793,49221,43974,19819,33733,15488,.68932331,.68533754,20125,13561,0,0
2006,42,Pennsylvania,White,31974,24910,51179,39321,36023,15156,27648,11673,.70386291,.70313573,,,0,0
2006,44,Rhode Island,Asian,171,106,317,184,228,89,131,53,.71924293,.7119565,,,0,0
2006,44,Rhode Island,Black,86,53,126,71,58,68,29,42,.46031746,.40845069,,,0,0
2006,44,Rhode Island,Hispanic,122,90,186,136,95,91,63,73,.51075268,.46323529,,,0,0
2006,44,Rhode Island,Total,3266,1982,5580,3023,3646,1934,1811,1212,.65340501,.59907377,1298,844,0,0
2006,44,Rhode Island,White,2612,1603,4386,2396,2887,1499,1449,947,.65823072,.60475791,,,0,0
2006,45,South Carolina,Asian,598,545,1260,1167,854,406,794,373,.67777777,.68037701,,,1,1
2006,45,South Carolina,Black,1811,1771,2665,2594,756,1909,716,1878,.28367731,.2760216,,,1,1
2006,45,South Carolina,Hispanic,324,301,510,468,275,235,247,221,.53921568,.52777779,,,1,1
2006,45,South Carolina,Total,14527,13044,24137,21539,13457,10680,11749,9790,.55752581,.54547566,7774,4532,1,1
2006,45,South Carolina,White,10846,9565,17830,15618,10490,7340,9048,6570,.58833426,.57933152,,,1,1
2006,46,South Dakota,Asian,62,57,138,131,89,49,85,46,.64492756,.64885497,,,0,0
2006,46,South Dakota,Black,19,19,39,39,18,21,18,21,.46153846,.46153846,,,0,0
2006,46,South Dakota,Hispanic,20,18,40,36,32,8,28,8,.80000001,.77777779,,,0,0
2006,46,South Dakota,Total,1905,1799,3092,2941,1902,1190,1811,1130,.61513585,.61577696,1281,764,0,0
2006,46,South Dakota,White,1702,1610,2709,2585,1662,1047,1587,998,.61351055,.61392647,,,0,0
2006,47,Tennessee,Asian,896,712,1800,1409,1248,552,940,469,.69333333,.66713983,,,0,0
2006,47,Tennessee,Black,1750,1605,2442,2205,677,1765,554,1651,.27723178,.25124717,,,0,0
2006,47,Tennessee,Hispanic,326,265,523,407,294,229,215,192,.56214148,.52825552,,,0,0
2006,47,Tennessee,Total,15479,11542,25585,18398,16096,9489,10691,7707,.62911862,.58109576,7087,4074,0,0
2006,47,Tennessee,White,11697,8331,19202,13138,12755,6447,8157,4981,.66425371,.62087077,,,0,0
2006,48,Texas,Asian,11016,10461,25702,24550,15812,9890,14964,9586,.61520505,.60953158,,,0,0
2006,48,Texas,Black,7516,7249,12200,11781,2790,9410,2562,9219,.22868852,.21746881,,,0,0
2006,48,Texas,Hispanic,40231,38847,63741,61546,23203,40538,21850,39696,.36402002,.355019,,,0,0
2006,48,Texas,Total,122969,114780,224168,209328,108824,115344,98424,110904,.48545733,.47019032,62376,34766,0,0
2006,48,Texas,White,56851,51462,107242,97356,59422,47820,52318,45038,.55409259,.53738856,,,0,0
2006,49,Utah,Asian,704,626,1293,1150,828,465,738,412,.6403712,.64173913,,,0,0
2006,49,Utah,Black,68,56,108,85,60,48,46,39,.55555558,.5411765,,,0,0
2006,49,Utah,Hispanic,712,655,1036,952,584,452,535,417,.56370658,.56197476,,,0,0
2006,49,Utah,Total,15483,14653,25127,23668,16454,8673,15508,8160,.65483344,.6552307,8848,6113,0,0
2006,49,Utah,White,13044,12431,20998,19939,13925,7073,13228,6711,.66315842,.66342342,,,0,0
2006,50,Vermont,Asian,105,60,183,103,112,71,71,32,.61202186,.68932039,,,0,0
2006,50,Vermont,Black,24,21,36,33,26,10,23,10,.72222221,.69696969,,,0,0
2006,50,Vermont,Hispanic,34,22,57,32,36,21,15,17,.63157892,.46875,,,0,0
2006,50,Vermont,Total,2856,2372,4434,3629,2889,1545,2335,1294,.65155613,.64342797,1669,1118,0,0
2006,50,Vermont,White,2516,2134,3864,3246,2522,1342,2091,1155,.65269148,.64417744,,,0,0
2006,51,Virginia,Asian,5386,5029,10930,10222,6503,4427,6022,4200,.59496796,.58912152,,,0,0
2006,51,Virginia,Black,4136,3951,6480,6156,2192,4288,2000,4156,.33827162,.32488629,,,0,0
2006,51,Virginia,Hispanic,2510,2310,4150,3773,2311,1839,2046,1727,.55686748,.54227406,,,0,0
2006,51,Virginia,Total,49877,44816,90464,80783,54832,35632,48046,32737,.60611957,.59475386,22933,14751,0,0
2006,51,Virginia,White,33520,29565,60282,52749,38645,21637,33305,19444,.64107031,.6313864,,,0,0
2006,53,Washington,Asian,3875,3608,6571,6147,3571,3000,3288,2859,.54344851,.53489506,,,0,0
2006,53,Washington,Black,586,527,920,816,370,550,308,508,.40217391,.37745097,,,0,0
2006,53,Washington,Hispanic,1295,1231,1904,1819,917,987,864,955,.48161766,.47498626,,,0,0
2006,53,Washington,Total,25891,23456,41132,37173,24663,16469,21798,15375,.59960616,.58639336,13314,8154,0,0
2006,53,Washington,White,17912,16231,27842,25271,17471,10371,15574,9697,.62750518,.61627954,,,0,0
2006,54,West Virginia,Asian,143,121,333,293,234,99,207,86,.7027027,.70648462,,,0,0
2006,54,West Virginia,Black,54,50,68,62,15,53,14,48,.22058824,.22580644,,,0,0
2006,54,West Virginia,Hispanic,52,48,77,73,39,38,37,36,.50649351,.50684929,,,0,0
2006,54,West Virginia,Total,3661,3438,5621,5220,2632,2989,2382,2838,.46824408,.45632184,2212,1065,0,0
2006,54,West Virginia,White,3235,3061,4844,4530,2182,2662,1988,2542,.45045418,.4388521,,,0,0
2006,55,Wisconsin,Asian,906,807,1599,1405,1074,525,943,462,.67166978,.67117441,,,0,0
2006,55,Wisconsin,Black,480,427,731,639,228,503,175,464,.31190151,.2738654,,,0,0
2006,55,Wisconsin,Hispanic,652,592,946,860,550,396,487,373,.58139533,.56627905,,,0,0
2006,55,Wisconsin,Total,23306,21178,36842,33411,25398,11444,22856,10555,.68937624,.68408608,13430,9356,0,0
2006,55,Wisconsin,White,20124,18342,31534,28723,22153,9381,20054,8669,.70251155,.6981861,,,0,0
2006,56,Wyoming,Asian,22,22,33,33,14,19,14,19,.42424244,.42424244,,,0,0
2006,56,Wyoming,Black,7,7,12,12,4,8,4,8,.33333334,.33333334,,,0,0
2006,56,Wyoming,Hispanic,38,38,57,57,26,31,26,31,.45614034,.45614034,,,0,0
2006,56,Wyoming,Total,1037,1037,1472,1472,735,737,735,737,.49932066,.49932066,728,368,0,0
2006,56,Wyoming,White,897,897,1244,1244,618,626,618,626,.49678457,.49678457,,,0,0
2007,1,Alabama,Asian,489,402,985,810,692,293,568,242,.70253807,.70123458,,,0,0
2007,1,Alabama,Black,1056,1003,1463,1367,407,1056,354,1013,.2781955,.25896123,,,0,0
2007,1,Alabama,Hispanic,187,148,322,248,203,119,149,99,.63043481,.60080647,,,0,0
2007,1,Alabama,Total,9215,7274,15448,12119,8982,6466,6765,5354,.58143449,.55821437,4181,2398,0,0
2007,1,Alabama,White,7196,5510,12171,9334,7369,4802,5485,3849,.60545558,.58763659,,,0,0
2007,2,Alaska,Asian,235,232,437,433,233,204,230,203,.53318077,.53117782,,,0,0
2007,2,Alaska,Black,50,47,69,66,21,48,20,46,.30434781,.30303031,,,0,0
2007,2,Alaska,Hispanic,76,70,119,111,68,51,64,47,.5714286,.57657659,,,0,0
2007,2,Alaska,Total,2466,2376,4148,4029,2668,1480,2594,1435,.64320153,.64383221,1497,957,0,0
2007,2,Alaska,White,1820,1772,3082,3014,2096,986,2052,962,.68007785,.68082285,,,0,0
2007,4,Arizona,Asian,1497,1354,2999,2723,1875,1124,1702,1021,.62520838,.6250459,,,0,0
2007,4,Arizona,Black,464,423,720,649,237,483,214,435,.32916668,.32973805,,,0,0
2007,4,Arizona,Hispanic,3595,3315,5313,4818,2055,3258,1779,3039,.38678712,.36924034,,,0,0
2007,4,Arizona,Total,18200,16055,30513,26638,16674,13839,14304,12334,.54645562,.53697723,9087,5428,0,0
2007,4,Arizona,White,11250,9751,19242,16523,11489,7753,9768,6755,.59707928,.59117591,,,0,0
2007,5,Arkansas,Asian,526,490,1223,1148,586,637,545,603,.47914964,.47473869,,,1,1
2007,5,Arkansas,Black,2053,2020,3182,3135,240,2942,230,2905,.075424261,.073365234,,,1,1
2007,5,Arkansas,Hispanic,623,611,931,913,303,628,294,619,.3254565,.32201535,,,1,1
2007,5,Arkansas,Total,16804,16018,27170,25951,8084,19086,7472,18479,.29753405,.28792724,8781,2620,1,1
2007,5,Arkansas,White,12861,12198,20608,19593,6577,14031,6054,13539,.31914791,.30898792,,,1,1
2007,6,California,Asian,58425,52894,120434,109043,75730,44704,68016,41027,.62880915,.62375391,,,0,0
2007,6,California,Black,7673,6663,12503,10789,4389,8114,3504,7285,.35103574,.32477525,,,0,0
2007,6,California,Hispanic,62135,57320,99779,92136,43259,56520,38787,53349,.43354815,.42097551,,,0,0
2007,6,California,Total,237559,206876,431403,374429,253264,178139,213991,160438,.58707058,.57151288,110253,72097,0,0
2007,6,California,White,84846,69573,154333,125703,104074,50259,83176,42527,.67434704,.66168666,,,0,0
2007,8,Colorado,Asian,1494,1416,2845,2677,1733,1112,1617,1060,.60913885,.60403436,,,0,0
2007,8,Colorado,Black,744,707,1120,1068,362,758,323,745,.32321429,.30243444,,,0,0
2007,8,Colorado,Hispanic,2362,2258,3457,3301,1435,2022,1338,1963,.4150998,.40533173,,,0,0
2007,8,Colorado,Total,25395,23629,43089,40049,26236,16853,24117,15932,.60887927,.60218734,13753,8569,0,0
2007,8,Colorado,White,19389,17963,33288,30831,21311,11977,19582,11249,.64020067,.63513994,,,0,0
2007,9,Connecticut,Asian,1674,1140,3527,2315,2797,730,1752,563,.79302526,.75680345,,,0,0
2007,9,Connecticut,Black,997,842,1468,1207,500,968,309,898,.34059945,.25600663,,,0,0
2007,9,Connecticut,Hispanic,1259,1074,1929,1604,1128,801,876,728,.58475894,.54613465,,,0,0
2007,9,Connecticut,Total,21389,16505,37314,27930,27378,9936,19976,7954,.73371923,.71521664,9819,7089,0,0
2007,9,Connecticut,White,16002,12385,27818,20989,21110,6708,15834,5155,.75886118,.75439519,,,0,0
2007,10,Delaware,Asian,377,297,858,679,629,229,487,192,.73310024,.71723121,,,0,0
2007,10,Delaware,Black,322,283,482,427,173,309,142,285,.35892117,.3325527,,,0,0
2007,10,Delaware,Hispanic,158,125,252,199,153,99,114,85,.60714287,.57286429,,,0,0
2007,10,Delaware,Total,4430,3023,7950,5360,5006,2944,2951,2409,.62968552,.5505597,1843,979,0,0
2007,10,Delaware,White,3301,2114,5872,3695,3745,2127,2005,1690,.6377725,.54262519,,,0,0
2007,11,District Of Columbia,Asian,182,79,366,157,217,149,52,105,.59289616,.3312102,,,0,0
2007,11,District Of Columbia,Black,1412,1148,2006,1583,334,1672,124,1459,.16650049,.078332283,,,0,0
2007,11,District Of Columbia,Hispanic,393,262,660,400,269,391,70,330,.40757576,.175,,,0,0
2007,11,District Of Columbia,Total,3886,1865,6966,2963,3799,3167,682,2281,.54536319,.23017213,1017,211,0,0
2007,11,District Of Columbia,White,1514,221,3215,554,2522,693,343,211,.78444791,.61913359,,,0,0
2007,12,Florida,Asian,7223,6692,15899,14690,8268,7631,7400,7290,.5200327,.50374407,,,0,1
2007,12,Florida,Black,11653,11345,18613,18055,4387,14226,4080,13975,.23569548,.22597618,,,0,1
2007,12,Florida,Hispanic,25889,22926,45263,39786,21306,23957,17697,22089,.47071558,.4448047,,,0,1
2007,12,Florida,Total,115379,103561,208825,186175,98327,110498,83344,102831,.47085837,.44766483,49234,26360,0,1
2007,12,Florida,White,62630,55486,115220,101448,58422,56798,49317,52131,.50704741,.48613083,,,0,1
2007,13,Georgia,Asian,4437,4129,8882,8269,5815,3067,5371,2898,.65469491,.6495344,,,0,0
2007,13,Georgia,Black,8902,8615,12189,11697,2918,9271,2681,9016,.23939617,.22920407,,,0,0
2007,13,Georgia,Hispanic,2177,1974,3239,2880,1654,1585,1391,1489,.51065141,.48298612,,,0,0
2007,13,Georgia,Total,49448,43280,79017,68143,43719,35298,35922,32221,.55328602,.52715611,21730,11592,0,0
2007,13,Georgia,White,30848,25878,49652,40996,30591,19061,24323,16673,.61610812,.59330177,,,0,0
2007,15,Hawaii,Asian,3199,1668,5308,2549,3166,2142,1144,1405,.5964582,.44880345,,,0,0
2007,15,Hawaii,Black,66,54,86,64,31,55,18,46,.36046511,.28125,,,0,0
2007,15,Hawaii,Hispanic,121,67,182,95,96,86,45,50,.52747256,.47368422,,,0,0
2007,15,Hawaii,Total,4889,2516,8058,3827,4899,3159,1782,2045,.60796726,.46563888,1702,867,0,0
2007,15,Hawaii,White,897,457,1515,750,988,527,419,331,.65214521,.55866665,,,0,0
2007,16,Idaho,Asian,118,111,245,233,169,76,160,73,.68979591,.68669528,,,0,0
2007,16,Idaho,Black,18,18,25,25,8,17,8,17,.31999999,.31999999,,,0,0
2007,16,Idaho,Hispanic,186,176,277,265,128,149,117,148,.46209386,.44150943,,,0,0
2007,16,Idaho,Total,3850,3706,6232,6023,3986,2246,3850,2173,.63960207,.63921636,2507,1605,0,0
2007,16,Idaho,White,3347,3227,5399,5224,3501,1898,3391,1833,.64845341,.64911944,,,0,0
2007,17,Illinois,Asian,6310,5867,13375,12517,10016,3359,9410,3107,.74885982,.75177759,,,0,0
2007,17,Illinois,Black,5240,4845,7479,6893,1642,5837,1439,5454,.21954806,.20876251,,,0,0
2007,17,Illinois,Hispanic,6254,5534,9429,8397,4178,5251,3614,4783,.44310108,.43039182,,,0,0
2007,17,Illinois,Total,55852,48588,98048,85633,66886,31162,58385,27248,.68217605,.6818049,27798,18857,0,0
2007,17,Illinois,White,34837,29579,62144,52974,47412,14732,40791,12183,.76293766,.77001923,,,0,0
2007,18,Indiana,Asian,1058,912,2118,1812,1493,625,1260,552,.70491028,.69536424,,,1,1
2007,18,Indiana,Black,746,688,1074,972,265,809,212,760,.24674116,.218107,,,1,1
2007,18,Indiana,Hispanic,525,440,786,628,308,478,222,406,.3918575,.3535032,,,1,1
2007,18,Indiana,Total,20921,18160,33291,28346,17722,15569,14465,13881,.53233606,.51030129,11306,5786,1,1
2007,18,Indiana,White,17695,15341,27844,23651,14870,12974,12094,11557,.53404683,.5113526,,,1,1
2007,19,Iowa,Asian,362,338,738,695,605,133,573,122,.81978321,.82446045,,,0,0
2007,19,Iowa,Black,78,75,121,118,75,46,74,44,.61983472,.62711865,,,0,0
2007,19,Iowa,Hispanic,138,126,205,187,122,83,111,76,.59512198,.59358287,,,0,0
2007,19,Iowa,Total,7127,6576,10776,9966,7565,3211,7019,2947,.70202303,.70429462,3989,2640,0,0
2007,19,Iowa,White,6213,5723,9171,8461,6368,2803,5890,2571,.69436264,.69613522,,,0,0
2007,20,Kansas,Asian,479,451,861,817,562,299,528,289,.65272939,.64626682,,,0,0
2007,20,Kansas,Black,220,216,278,270,102,176,97,173,.36690646,.35925925,,,0,0
2007,20,Kansas,Hispanic,289,273,368,337,170,198,146,191,.46195653,.43323442,,,0,0
2007,20,Kansas,Total,6776,6323,9994,9335,6311,3683,5819,3516,.63147891,.62335294,3519,2208,0,0
2007,20,Kansas,White,5453,5076,7980,7448,5161,2819,4764,2684,.64674187,.63963479,,,0,0
2007,21,Kentucky,Asian,611,555,1167,1059,728,439,662,397,.62382179,.62511802,,,0,0
2007,21,Kentucky,Black,570,551,804,772,244,560,227,545,.30348259,.29404145,,,0,0
2007,21,Kentucky,Hispanic,259,228,396,337,215,181,172,165,.54292929,.51038575,,,0,0
2007,21,Kentucky,Total,15408,13246,24534,20787,12419,12115,9913,10874,.50619549,.4768846,7036,3518,0,0
2007,21,Kentucky,White,13381,11395,21153,17726,10696,10457,8404,9322,.50564933,.47410583,,,0,0
2007,22,Louisiana,Asian,391,296,726,552,484,242,347,205,.66666669,.62862319,,,0,0
2007,22,Louisiana,Black,562,451,726,591,237,489,178,413,.32644629,.30118445,,,0,0
2007,22,Louisiana,Hispanic,176,96,265,145,166,99,78,67,.62641507,.53793103,,,0,0
2007,22,Louisiana,Total,5456,3193,8099,4505,4613,3486,2219,2286,.5695765,.49256381,1957,920,0,0
2007,22,Louisiana,White,4056,2186,5960,2972,3485,2475,1494,1478,.58473152,.50269181,,,0,0
2007,23,Maine,Asian,258,217,391,322,218,173,169,153,.55754477,.52484471,,,0,0
2007,23,Maine,Black,61,55,91,84,47,44,44,40,.51648355,.52380955,,,0,0
2007,23,Maine,Hispanic,95,85,144,127,87,57,77,50,.60416669,.60629922,,,0,0
2007,23,Maine,Total,6604,6083,10113,9233,6118,3995,5496,3737,.6049639,.59525615,3680,2275,0,0
2007,23,Maine,White,5904,5468,9071,8321,5536,3535,4997,3324,.61029655,.60052878,,,0,0
2007,24,Maryland,Asian,5180,4788,11454,10624,8205,3249,7646,2978,.71634364,.71969128,,,0,0
2007,24,Maryland,Black,6052,5536,9387,8567,3102,6285,2697,5870,.330457,.31481266,,,0,0
2007,24,Maryland,Hispanic,2477,2245,4143,3742,2409,1734,2118,1624,.58146268,.56600749,,,0,0
2007,24,Maryland,Total,45018,38599,83060,71501,53146,29914,45142,26359,.63985074,.63134784,20232,12882,0,0
2007,24,Maryland,White,28206,23410,52359,43801,35884,16475,29770,14031,.68534541,.67966485,,,0,0
2007,25,Massachusetts,Asian,3494,2605,7115,5254,5462,1653,3918,1336,.76767391,.74571753,,,0,0
2007,25,Massachusetts,Black,1133,885,1655,1272,728,927,491,781,.43987915,.3860063,,,0,0
2007,25,Massachusetts,Hispanic,1501,1211,2225,1759,1245,980,906,853,.55955058,.51506537,,,0,0
2007,25,Massachusetts,Total,34884,26499,60117,44833,44218,15899,32146,12687,.7355324,.71701646,17036,12307,0,0
2007,25,Massachusetts,White,26416,20111,45040,33659,33842,11198,24833,8826,.75137657,.73778188,,,0,0
2007,26,Michigan,Asian,2626,2305,5340,4696,4107,1233,3609,1087,.76910114,.76852643,,,0,0
2007,26,Michigan,Black,1588,1449,2190,1985,744,1446,614,1371,.33972603,.30931991,,,0,0
2007,26,Michigan,Hispanic,821,722,1265,1096,715,550,610,486,.56521738,.55656934,,,0,0
2007,26,Michigan,Total,36581,31835,57806,50103,37951,19855,32490,17613,.65652353,.64846414,20129,13062,0,0
2007,26,Michigan,White,29354,25451,45595,39413,30272,15323,25907,13506,.66393244,.65732121,,,0,0
2007,27,Minnesota,Asian,1778,1612,3265,2986,1840,1425,1663,1323,.56355286,.55693233,,,0,0
2007,27,Minnesota,Black,566,508,822,739,264,558,224,515,.32116789,.30311233,,,0,0
2007,27,Minnesota,Hispanic,470,393,736,610,388,348,308,302,.52717394,.50491804,,,0,0
2007,27,Minnesota,Total,25988,22916,41763,36757,26116,15647,22612,14145,.6253382,.61517537,12527,7815,0,0
2007,27,Minnesota,White,21874,19281,34805,30587,22353,12452,19349,11238,.64223534,.63258898,,,0,0
2007,28,Mississippi,Asian,173,126,295,199,175,120,94,105,.59322035,.4723618,,,0,0
2007,28,Mississippi,Black,1329,1301,1989,1947,241,1748,218,1729,.12116642,.11196713,,,0,0
2007,28,Mississippi,Hispanic,64,53,93,74,39,54,31,43,.41935483,.41891891,,,0,0
2007,28,Mississippi,Total,4934,4047,7468,5940,2754,4714,1891,4049,.36877343,.31835017,2605,845,0,0
2007,28,Mississippi,White,3138,2379,4701,3412,2163,2538,1465,1947,.46011487,.42936695,,,0,0
2007,29,Missouri,Asian,701,564,1442,1159,1089,353,884,275,.7552011,.76272649,,,0,0
2007,29,Missouri,Black,736,640,976,824,280,696,179,645,.28688523,.21723302,,,0,0
2007,29,Missouri,Hispanic,313,248,484,362,302,182,207,155,.62396693,.57182318,,,0,0
2007,29,Missouri,Total,12742,9514,20842,14986,14372,6470,9823,5163,.68956912,.65547842,5846,3686,0,0
2007,29,Missouri,White,10344,7544,16849,11794,11972,4877,8011,3783,.71054661,.67924368,,,0,0
2007,30,Montana,Asian,55,46,102,88,80,22,69,19,.78431374,.78409094,,,0,0
2007,30,Montana,Black,5,4,7,6,3,4,3,3,.42857143,.5,,,0,0
2007,30,Montana,Hispanic,39,39,67,67,36,31,36,31,.53731346,.53731346,,,0,0
2007,30,Montana,Total,2469,2280,3757,3494,2450,1307,2296,1198,.65211606,.65712649,1543,1033,0,0
2007,30,Montana,White,2195,2020,3328,3084,2167,1161,2027,1057,.65114182,.65726328,,,0,0
2007,31,Nebraska,Asian,203,171,368,317,225,143,196,121,.61141306,.6182965,,,0,0
2007,31,Nebraska,Black,74,68,107,96,52,55,46,50,.48598132,.47916666,,,0,0
2007,31,Nebraska,Hispanic,127,115,184,168,88,96,76,92,.47826087,.45238096,,,0,0
2007,31,Nebraska,Total,3743,3179,5842,4980,3414,2428,2825,2155,.58438891,.56726909,1882,1105,0,0
2007,31,Nebraska,White,3159,2664,4922,4167,2891,2031,2369,1798,.58736289,.56851453,,,0,0
2007,32,Nevada,Asian,1347,1268,2618,2425,1195,1423,1089,1336,.45645532,.44907215,,,0,0
2007,32,Nevada,Black,356,343,584,555,164,420,149,406,.28082192,.26846847,,,0,0
2007,32,Nevada,Hispanic,1263,1220,1990,1901,778,1212,737,1164,.39095476,.38769069,,,0,0
2007,32,Nevada,Total,8379,7799,14664,13388,7312,7352,6581,6807,.49863613,.49155959,4371,2430,0,0
2007,32,Nevada,White,4827,4432,8439,7593,4683,3756,4201,3392,.55492359,.55327272,,,0,0
2007,33,New Hampshire,Asian,373,150,681,257,534,147,196,61,.78414094,.7626459,,,0,0
2007,33,New Hampshire,Black,41,21,54,24,31,23,17,7,.57407409,.70833331,,,0,0
2007,33,New Hampshire,Hispanic,112,69,160,93,110,50,58,35,.6875,.62365592,,,0,0
2007,33,New Hampshire,Total,5385,4049,8157,5902,5838,2319,4132,1770,.71570432,.70010167,2850,2052,0,0
2007,33,New Hampshire,White,4606,3647,6878,5293,4886,1992,3694,1599,.71038091,.69790292,,,0,0
2007,34,New Jersey,Asian,7062,6312,14901,13314,11544,3357,10387,2927,.7747131,.78015625,,,0,0
2007,34,New Jersey,Black,2022,1680,3039,2483,1132,1907,837,1646,.37249094,.33709222,,,0,0
2007,34,New Jersey,Hispanic,3603,3063,5437,4565,3049,2388,2501,2064,.5607872,.5478642,,,0,0
2007,34,New Jersey,Total,42416,34344,76449,61842,54263,22186,44235,17607,.70979345,.71529061,21944,15772,0,0
2007,34,New Jersey,White,26604,20778,47460,36983,34715,12745,27485,9498,.73145807,.74317932,,,0,0
2007,35,New Mexico,Asian,275,236,551,475,339,212,276,199,.61524498,.58105266,,,0,0
2007,35,New Mexico,Black,111,108,172,167,56,116,52,115,.3255814,.31137726,,,0,0
2007,35,New Mexico,Hispanic,2353,2154,3487,3193,1122,2365,943,2250,.32176656,.29533353,,,0,0
2007,35,New Mexico,Total,6796,6030,11040,9825,4917,6123,4091,5734,.44538045,.41638678,3434,1642,0,0
2007,35,New Mexico,White,3247,2885,5498,4890,2929,2569,2452,2438,.53273916,.50143147,,,0,0
2007,36,New York,Asian,13477,12327,25611,23574,17802,7809,16406,7168,.69509196,.6959362,,,0,0
2007,36,New York,Black,7484,6430,10764,9261,3699,7065,2971,6290,.34364548,.3208077,,,0,0
2007,36,New York,Hispanic,11102,9336,16035,13462,8263,7772,6744,6718,.51531029,.50096565,,,0,0
2007,36,New York,Total,113368,96355,193014,164873,125146,67868,105902,58971,.64837784,.64232469,54201,35707,0,0
2007,36,New York,White,72241,60692,125107,105644,86030,39077,72202,33442,.6876514,.68344629,,,0,0
2007,37,North Carolina,Asian,2371,2135,5497,4967,3538,1959,3161,1806,.64362377,.63640022,,,0,0
2007,37,North Carolina,Black,4388,4165,7312,6917,1948,5364,1802,5115,.26641136,.26051757,,,0,0
2007,37,North Carolina,Hispanic,1495,1349,2644,2355,1432,1212,1259,1096,.54160362,.53460723,,,0,0
2007,37,North Carolina,Total,43152,38154,81151,71378,47086,34065,40424,30954,.58022696,.56633699,22315,12858,0,0
2007,37,North Carolina,White,32754,28635,61562,53547,37857,23705,32285,21262,.61494106,.60292828,,,0,0
2007,38,North Dakota,Asian,36,32,70,66,59,11,57,9,.84285712,.86363637,,,0,0
2007,38,North Dakota,Black,8,7,9,8,6,3,6,2,.66666669,.75,,,0,0
2007,38,North Dakota,Hispanic,5,5,5,5,2,3,5,0,.40000001,1,,,0,0
2007,38,North Dakota,Total,1182,1113,1716,1633,1219,497,1163,470,.71037298,.71218616,768,542,0,0
2007,38,North Dakota,White,1102,1039,1578,1501,1111,467,1058,443,.70405579,.70486343,,,0,0
2007,39,Ohio,Asian,2107,1760,4423,3710,3442,981,2868,842,.77820486,.77304584,,,0,0
2007,39,Ohio,Black,2261,2036,3288,2944,923,2365,729,2215,.28071776,.24762228,,,0,0
2007,39,Ohio,Hispanic,710,547,1094,850,661,433,477,373,.60420477,.56117648,,,0,0
2007,39,Ohio,Total,41028,32910,66232,52809,42620,23612,32863,19946,.64349562,.62229925,19929,12301,0,0
2007,39,Ohio,White,33835,26869,54018,42613,35449,18569,27167,15446,.65624422,.63752848,,,0,0
2007,40,Oklahoma,Asian,810,741,1652,1499,898,754,777,722,.54358351,.51834553,,,0,0
2007,40,Oklahoma,Black,720,703,1086,1063,240,846,229,834,.22099447,.21542804,,,0,0
2007,40,Oklahoma,Hispanic,756,721,1202,1134,482,720,437,697,.40099832,.38536155,,,0,0
2007,40,Oklahoma,Total,12890,11888,21656,19809,10199,11457,8951,10858,.47095492,.45186532,7018,3268,0,0
2007,40,Oklahoma,White,8812,8054,14807,13456,7366,7441,6469,6987,.49746743,.48075208,,,0,0
2007,41,Oregon,Asian,1173,1030,1999,1775,1261,738,1113,662,.63081539,.62704223,,,0,0
2007,41,Oregon,Black,121,113,168,152,67,101,56,96,.39880952,.36842105,,,0,0
2007,41,Oregon,Hispanic,565,528,806,754,360,446,328,426,.44665012,.43501326,,,0,0
2007,41,Oregon,Total,11314,10096,17231,15357,10583,6648,9241,6116,.61418372,.60174513,6107,3812,0,0
2007,41,Oregon,White,8625,7689,12924,11488,8072,4852,7030,4458,.62457442,.61194289,,,0,0
2007,42,Pennsylvania,Asian,3098,2464,5887,4724,4227,1660,3432,1292,.71802276,.72650295,,,0,0
2007,42,Pennsylvania,Black,1888,1609,2554,2144,655,1899,456,1688,.25646046,.21268657,,,0,0
2007,42,Pennsylvania,Hispanic,1007,814,1519,1229,802,717,635,594,.52797896,.51668024,,,0,0
2007,42,Pennsylvania,Total,42689,33828,69430,54252,47447,21983,36862,17390,.68337893,.6794588,21887,14442,0,0
2007,42,Pennsylvania,White,34493,27299,55819,43521,39391,16428,30698,12823,.70569164,.70536065,,,0,0
2007,44,Rhode Island,Asian,194,127,405,261,302,103,191,70,.74567902,.73180079,,,0,0
2007,44,Rhode Island,Black,58,38,86,52,39,47,22,30,.45348838,.42307693,,,0,0
2007,44,Rhode Island,Hispanic,126,82,207,131,101,106,62,69,.4879227,.47328246,,,0,0
2007,44,Rhode Island,Total,3544,2194,6078,3474,3886,2192,2014,1460,.63935506,.57973516,1438,900,0,0
2007,44,Rhode Island,White,2899,1781,4927,2773,3163,1764,1602,1171,.64197278,.57771367,,,0,0
2007,45,South Carolina,Asian,637,583,1315,1207,895,420,821,386,.68060839,.68019885,,,1,1
2007,45,South Carolina,Black,2025,1978,2869,2788,867,2002,831,1957,.30219588,.29806313,,,1,1
2007,45,South Carolina,Hispanic,394,376,676,644,349,327,330,314,.51627219,.51242238,,,1,1
2007,45,South Carolina,Total,15788,14169,26117,23255,14922,11195,13073,10182,.57135201,.5621587,8142,4765,1,1
2007,45,South Carolina,White,12047,10612,20092,17577,12184,7908,10542,7035,.6064105,.59976107,,,1,1
2007,46,South Dakota,Asian,51,46,118,108,90,28,85,23,.76271188,.78703701,,,0,0
2007,46,South Dakota,Black,9,9,14,14,8,6,8,6,.5714286,.5714286,,,0,0
2007,46,South Dakota,Hispanic,26,23,38,34,23,15,19,15,.60526317,.55882353,,,0,0
2007,46,South Dakota,Total,1948,1809,3211,3012,2072,1139,1944,1068,.64528185,.64541835,1268,793,0,0
2007,46,South Dakota,White,1770,1661,2892,2732,1853,1039,1739,993,.64073306,.63653004,,,0,0
2007,47,Tennessee,Asian,975,780,2187,1763,1577,610,1243,520,.72107911,.7050482,,,0,0
2007,47,Tennessee,Black,2027,1875,2854,2604,756,2098,633,1971,.26489139,.24308756,,,0,0
2007,47,Tennessee,Hispanic,398,346,635,539,367,268,302,237,.57795274,.56029683,,,0,0
2007,47,Tennessee,Total,17256,13176,28791,21259,17913,10878,12221,9038,.62217361,.57486242,7954,4344,0,0
2007,47,Tennessee,White,13111,9641,21814,15486,14421,7393,9573,5913,.66108918,.61817127,,,0,0
2007,48,Texas,Asian,12220,11600,28577,27297,17861,10716,16937,10360,.62501311,.62047112,,,0,0
2007,48,Texas,Black,8752,8480,14358,13894,3426,10932,3177,10717,.23861262,.22865985,,,0,0
2007,48,Texas,Hispanic,45612,43971,73244,70561,23480,49764,21900,48661,.32057235,.31036976,,,0,0
2007,48,Texas,Total,135130,126232,246096,230007,116809,129287,105740,124267,.47464812,.45972514,65788,34869,0,0
2007,48,Texas,White,62111,56313,118063,107467,66346,51717,58774,48693,.5619542,.54690278,,,0,0
2007,49,Utah,Asian,704,614,1304,1142,824,480,728,414,.63190186,.63747811,,,0,0
2007,49,Utah,Black,66,56,108,87,43,65,33,54,.39814815,.37931034,,,0,0
2007,49,Utah,Hispanic,644,598,950,886,503,447,473,413,.52947366,.53386003,,,0,0
2007,49,Utah,Total,14990,14188,24183,22712,15931,8252,14956,7756,.65876853,.65850651,8737,5896,0,0
2007,49,Utah,White,12909,12304,20766,19653,13873,6893,13112,6541,.66806316,.66717547,,,0,0
2007,50,Vermont,Asian,128,79,236,156,179,57,121,35,.75847459,.77564102,,,0,0
2007,50,Vermont,Black,25,19,43,32,28,15,21,11,.6511628,.65625,,,0,0
2007,50,Vermont,Hispanic,31,26,52,43,35,17,29,14,.67307693,.67441863,,,0,0
2007,50,Vermont,Total,3270,2874,5219,4574,3543,1676,3076,1498,.67886567,.67249674,1913,1311,0,0
2007,50,Vermont,White,2957,2641,4708,4195,3179,1529,2809,1386,.67523366,.66960669,,,0,0
2007,51,Virginia,Asian,6316,5871,13251,12306,8238,5013,7587,4719,.6216889,.61652851,,,0,0
2007,51,Virginia,Black,4643,4424,7108,6738,2392,4716,2201,4537,.33652222,.32665479,,,0,0
2007,51,Virginia,Hispanic,2938,2734,4911,4538,2664,2247,2407,2131,.54245573,.53040987,,,0,0
2007,51,Virginia,Total,55201,49884,100435,90264,60823,39612,53947,36317,.60559565,.59765798,25627,16007,0,0
2007,51,Virginia,White,36821,32747,66993,59201,42824,24169,37486,21715,.63923097,.63319874,,,0,0
2007,53,Washington,Asian,4444,4079,8109,7470,4729,3380,4289,3181,.58317918,.57416332,,,0,0
2007,53,Washington,Black,617,559,947,849,334,613,290,559,.35269272,.34157833,,,0,0
2007,53,Washington,Hispanic,1643,1551,2329,2194,1030,1299,945,1249,.44224989,.43072015,,,0,0
2007,53,Washington,Total,28785,26006,46751,42220,28219,18532,25018,17202,.60360205,.59256279,14741,8938,0,0
2007,53,Washington,White,19823,17825,31714,28480,20048,11666,17691,10789,.63214982,.62117273,,,0,0
2007,54,West Virginia,Asian,123,103,279,231,204,75,170,61,.73118281,.73593074,,,0,0
2007,54,West Virginia,Black,58,53,75,69,34,41,32,37,.45333335,.46376812,,,0,0
2007,54,West Virginia,Hispanic,56,53,83,79,43,40,40,39,.51807231,.50632912,,,0,0
2007,54,West Virginia,Total,4093,3818,6162,5656,2967,3195,2648,3008,.48149952,.46817538,2505,1148,0,0
2007,54,West Virginia,White,3668,3440,5444,5034,2562,2882,2306,2728,.47060984,.45808503,,,0,0
2007,55,Wisconsin,Asian,1000,874,1847,1609,1246,601,1092,517,.67460746,.67868239,,,0,0
2007,55,Wisconsin,Black,515,447,745,648,238,507,197,451,.31946307,.30401236,,,0,0
2007,55,Wisconsin,Hispanic,733,637,1104,972,600,504,523,449,.54347825,.53806585,,,0,0
2007,55,Wisconsin,Total,25020,22722,39811,36237,27136,12675,24570,11667,.68162066,.67803627,14454,10053,0,0
2007,55,Wisconsin,White,21785,19887,34565,31626,24082,10483,21896,9730,.69671631,.69234174,,,0,0
2007,56,Wyoming,Asian,29,29,51,51,27,24,27,24,.52941179,.52941179,,,0,0
2007,56,Wyoming,Black,9,8,18,17,9,9,9,8,.5,.52941179,,,0,0
2007,56,Wyoming,Hispanic,42,41,55,54,24,31,24,30,.43636364,.44444445,,,0,0
2007,56,Wyoming,Total,1132,1124,1725,1716,878,847,873,843,.50898552,.50874126,825,443,0,0
2007,56,Wyoming,White,996,990,1490,1483,759,731,754,729,.50939596,.50842887,,,0,0
2008,1,Alabama,Asian,557,468,1146,980,784,362,664,316,.68411869,.67755103,,,0,0
2008,1,Alabama,Black,1439,1375,1906,1811,451,1455,402,1409,.2366212,.2219768,,,0,0
2008,1,Alabama,Hispanic,268,221,448,362,233,215,174,188,.52008927,.48066297,,,0,0
2008,1,Alabama,Total,10813,8841,17863,14634,9330,8533,7260,7374,.52230871,.49610496,5290,2689,0,0
2008,1,Alabama,White,8213,6514,13829,11063,7622,6207,5860,5203,.55116063,.52969354,,,0,0
2008,2,Alaska,Asian,251,248,458,451,242,216,238,213,.52838427,.52771616,,,0,0
2008,2,Alaska,Black,54,54,76,76,32,44,32,44,.42105263,.42105263,,,0,0
2008,2,Alaska,Hispanic,93,91,135,130,71,64,70,60,.52592593,.53846157,,,0,0
2008,2,Alaska,Total,2476,2397,4036,3928,2481,1555,2419,1509,.61471754,.61583501,1621,1063,0,0
2008,2,Alaska,White,1781,1722,2869,2790,1864,1005,1818,972,.64970374,.65161288,,,0,0
2008,4,Arizona,Asian,1739,1568,3581,3242,2211,1370,1993,1249,.61742532,.61474401,,,0,0
2008,4,Arizona,Black,570,534,899,839,311,588,281,558,.34593993,.33492252,,,0,0
2008,4,Arizona,Hispanic,4531,4248,6701,6234,2511,4190,2252,3982,.37472019,.3612448,,,0,0
2008,4,Arizona,Total,20236,18235,33913,30282,17941,15972,15675,14607,.52903014,.51763421,10572,5985,0,0
2008,4,Arizona,White,12026,10635,20476,17942,11914,8562,10296,7646,.5818519,.57384908,,,0,0
2008,5,Arkansas,Asian,594,550,1366,1277,611,755,569,708,.44729137,.44557557,,,1,1
2008,5,Arkansas,Black,2265,2237,3526,3483,227,3299,210,3273,.064378902,.060292851,,,1,1
2008,5,Arkansas,Hispanic,728,720,1120,1105,362,758,351,754,.32321429,.31764707,,,1,1
2008,5,Arkansas,Total,17729,17039,29339,28236,8588,20751,8006,20230,.29271618,.28353876,9682,3081,1,1
2008,5,Arkansas,White,13400,12818,22050,21141,6997,15053,6503,14638,.31732425,.30760133,,,1,1
2008,6,California,Asian,62200,56269,127143,115254,79281,47862,71224,44030,.62355775,.61797422,,,0,0
2008,6,California,Black,7997,6989,12895,11229,4476,8419,3593,7636,.34711128,.31997508,,,0,0
2008,6,California,Hispanic,68201,63040,110901,102647,48916,61985,44033,58614,.44107807,.42897505,,,0,0
2008,6,California,Total,250168,218376,453166,395069,264154,189012,224070,170999,.5829078,.56716675,119338,78342,0,0
2008,6,California,White,87587,71871,158593,129703,106395,52198,85347,44356,.67086822,.65801871,,,0,0
2008,8,Colorado,Asian,1614,1515,3102,2909,1795,1307,1673,1236,.57865894,.57511175,,,0,0
2008,8,Colorado,Black,859,815,1293,1234,406,887,374,860,.31399846,.30307943,,,0,0
2008,8,Colorado,Hispanic,2776,2645,4109,3911,1668,2441,1544,2367,.40593818,.39478394,,,0,0
2008,8,Colorado,Total,27756,25798,46369,43075,27275,19094,25054,18021,.58821625,.58163667,14777,9185,0,0
2008,8,Colorado,White,20968,19421,35289,32685,22017,13272,20233,12452,.62390548,.61903012,,,0,0
2008,9,Connecticut,Asian,1830,1239,3894,2554,2992,902,1902,652,.76836157,.7447142,,,0,0
2008,9,Connecticut,Black,1010,846,1485,1206,514,971,322,884,.34612796,.26699835,,,0,0
2008,9,Connecticut,Hispanic,1376,1155,2131,1764,1224,907,954,810,.57437825,.54081631,,,0,0
2008,9,Connecticut,Total,22322,17308,38932,29277,28243,10689,20672,8605,.72544438,.7060833,10626,7658,0,0
2008,9,Connecticut,White,16758,13120,28978,22090,21799,7179,16404,5686,.75226033,.74259847,,,0,0
2008,10,Delaware,Asian,387,311,868,710,623,245,497,213,.71774191,.69999999,,,0,0
2008,10,Delaware,Black,377,331,550,489,161,389,123,366,.29272726,.25153375,,,0,0
2008,10,Delaware,Hispanic,156,115,242,178,117,125,78,100,.48347107,.43820226,,,0,0
2008,10,Delaware,Total,4645,3218,8117,5574,4800,3317,2902,2672,.59135151,.52063149,1943,1000,0,0
2008,10,Delaware,White,3469,2280,5996,3876,3636,2360,2050,1826,.60640424,.5288958,,,0,0
2008,11,District Of Columbia,Asian,181,77,367,145,231,136,53,92,.62942779,.36551723,,,0,0
2008,11,District Of Columbia,Black,2080,1781,3111,2661,337,2774,140,2521,.1083253,.052611802,,,0,0
2008,11,District Of Columbia,Hispanic,439,325,713,481,251,462,67,414,.35203367,.13929313,,,0,0
2008,11,District Of Columbia,Total,4621,2592,8165,4189,3784,4381,707,3482,.46344152,.16877536,1392,295,0,0
2008,11,District Of Columbia,White,1512,227,3238,592,2566,672,385,207,.79246449,.65033782,,,0,0
2008,12,Florida,Asian,8142,7542,17596,16208,8705,8891,7754,8454,.49471471,.47840571,,,0,1
2008,12,Florida,Black,15154,14775,24094,23421,4736,19358,4400,19021,.19656345,.18786559,,,0,1
2008,12,Florida,Hispanic,29290,26031,51498,45473,22724,28774,18882,26591,.44125986,.4152354,,,0,1
2008,12,Florida,Total,130470,117694,235030,210317,104256,130774,88277,122040,.44358593,.41973308,53816,28667,0,1
2008,12,Florida,White,69009,61358,126485,111577,61948,64537,52191,59386,.48976558,.4677577,,,0,1
2008,13,Georgia,Asian,5238,4912,10542,9846,6622,3920,6096,3750,.62815404,.61913466,,,0,0
2008,13,Georgia,Black,10586,10250,14776,14255,3530,11246,3275,10980,.23890091,.22974394,,,0,0
2008,13,Georgia,Hispanic,2939,2682,4542,4070,2254,2288,1938,2132,.49625716,.47616708,,,0,0
2008,13,Georgia,Total,57115,50498,92232,80298,48996,43236,40660,39638,.53122562,.50636381,24490,13149,0,0
2008,13,Georgia,White,35157,29755,57319,47582,34163,23156,27293,20289,.59601527,.57359928,,,0,0
2008,15,Hawaii,Asian,3490,1946,5747,2969,3177,2570,1212,1757,.55281013,.40821826,,,0,0
2008,15,Hawaii,Black,70,58,105,82,36,69,23,59,.34285715,.28048781,,,0,0
2008,15,Hawaii,Hispanic,131,86,207,123,101,106,41,82,.4879227,.33333334,,,0,0
2008,15,Hawaii,Total,5338,2930,8857,4496,5065,3792,1930,2566,.57186407,.42927048,1849,892,0,0
2008,15,Hawaii,White,966,519,1663,845,1029,634,439,406,.6187613,.5195266,,,0,0
2008,16,Idaho,Asian,139,133,278,271,183,95,179,92,.6582734,.66051662,,,0,0
2008,16,Idaho,Black,18,17,35,34,15,20,15,19,.42857143,.44117647,,,0,0
2008,16,Idaho,Hispanic,157,148,233,223,110,123,104,119,.472103,.46636772,,,0,0
2008,16,Idaho,Total,4017,3870,6522,6319,4206,2316,4071,2248,.64489418,.64424753,2432,1596,0,0
2008,16,Idaho,White,3476,3350,5590,5414,3632,1958,3513,1901,.64973164,.64887327,,,0,0
2008,17,Illinois,Asian,6729,6254,14386,13449,10450,3936,9838,3611,.72640067,.7315042,,,0,0
2008,17,Illinois,Black,5750,5294,8226,7547,1667,6559,1449,6098,.20265013,.19199681,,,0,0
2008,17,Illinois,Hispanic,7281,6580,11061,10069,4804,6257,4283,5786,.43431878,.42536497,,,0,0
2008,17,Illinois,Total,60398,52937,106305,93704,70610,35695,62075,31629,.66422087,.66245836,30529,20293,0,0
2008,17,Illinois,White,37434,31991,66956,57623,50071,16885,43323,14300,.74781948,.75183523,,,0,0
2008,18,Indiana,Asian,1205,1031,2400,2075,1651,749,1419,656,.6879167,.68385541,,,1,1
2008,18,Indiana,Black,910,842,1324,1210,341,983,280,930,.25755286,.23140496,,,1,1
2008,18,Indiana,Hispanic,682,603,993,852,381,612,299,553,.3836858,.35093898,,,1,1
2008,18,Indiana,Total,23237,20385,36907,31846,19126,17781,15833,16013,.5182215,.49717391,12393,6283,1,1
2008,18,Indiana,White,19579,17170,30748,26501,15965,14783,13204,13297,.51922077,.49824536,,,1,1
2008,19,Iowa,Asian,419,392,861,807,649,212,613,194,.7537747,.75960344,,,0,0
2008,19,Iowa,Black,104,102,166,163,88,78,88,75,.53012049,.5398773,,,0,0
2008,19,Iowa,Hispanic,159,145,233,213,142,91,127,86,.60944206,.59624416,,,0,0
2008,19,Iowa,Total,7798,7156,11786,10815,7886,3900,7277,3538,.66909891,.67286175,4446,2932,0,0
2008,19,Iowa,White,6792,6212,10016,9152,6671,3345,6131,3021,.66603434,.66990823,,,0,0
2008,20,Kansas,Asian,573,531,1042,956,636,406,589,367,.61036468,.61610878,,,0,0
2008,20,Kansas,Black,299,291,362,352,117,245,111,241,.32320443,.31534091,,,0,0
2008,20,Kansas,Hispanic,355,339,484,458,214,270,200,258,.44214877,.43668121,,,0,0
2008,20,Kansas,Total,7766,7287,11755,11001,6963,4792,6484,4517,.59234369,.58940095,4070,2562,0,0
2008,20,Kansas,White,6165,5783,9335,8761,5720,3615,5343,3418,.61274773,.60986191,,,0,0
2008,21,Kentucky,Asian,668,602,1341,1216,846,495,763,453,.63087249,.6274671,,,0,0
2008,21,Kentucky,Black,712,687,1006,969,286,720,268,701,.28429425,.27657378,,,0,0
2008,21,Kentucky,Hispanic,324,283,503,441,240,263,207,234,.47713718,.46938777,,,0,0
2008,21,Kentucky,Total,16944,14688,27340,23309,13557,13783,10941,12368,.49586686,.4693895,7864,3967,0,0
2008,21,Kentucky,White,14584,12534,23397,19720,11639,11758,9246,10474,.49745694,.46886408,,,0,0
2008,22,Louisiana,Asian,442,334,773,586,491,282,381,205,.63518757,.65017062,,,0,0
2008,22,Louisiana,Black,875,745,1132,947,243,889,182,765,.21466431,.19218585,,,0,0
2008,22,Louisiana,Hispanic,240,135,352,191,225,127,106,85,.63920456,.55497384,,,0,0
2008,22,Louisiana,Total,6423,3973,9547,5647,4955,4592,2539,3108,.5190112,.44961926,2505,1116,0,0
2008,22,Louisiana,White,4610,2596,6890,3687,3783,3107,1762,1925,.54905659,.47789532,,,0,0
2008,23,Maine,Asian,336,278,606,492,331,275,263,229,.54620463,.53455287,,,0,0
2008,23,Maine,Black,68,60,102,92,41,61,36,56,.40196079,.39130434,,,0,0
2008,23,Maine,Hispanic,90,83,148,132,84,64,76,56,.56756759,.57575756,,,0,0
2008,23,Maine,Total,7505,6918,11697,10695,6519,5178,5868,4827,.55732238,.54866761,4223,2554,0,0
2008,23,Maine,White,6673,6190,10317,9504,5766,4551,5224,4280,.55888337,.54966331,,,0,0
2008,24,Maryland,Asian,5695,5264,12759,11886,8968,3791,8393,3493,.70287639,.70612484,,,0,0
2008,24,Maryland,Black,7812,7185,12259,11273,3498,8761,3077,8196,.28534138,.27295306,,,0,0
2008,24,Maryland,Hispanic,2958,2703,5070,4597,2837,2233,2516,2081,.55956608,.54731345,,,0,0
2008,24,Maryland,Total,49493,42641,90768,78551,55767,35001,47335,31216,.61439055,.60260212,21963,13768,0,0
2008,24,Maryland,White,29592,24505,54510,45455,36860,17650,30312,15143,.67620617,.6668573,,,0,0
2008,25,Massachusetts,Asian,3836,2908,7921,5991,6049,1872,4458,1533,.76366621,.74411619,,,0,0
2008,25,Massachusetts,Black,1322,1082,2005,1614,767,1238,525,1089,.38254365,.32527882,,,0,0
2008,25,Massachusetts,Hispanic,1731,1450,2576,2130,1360,1216,1047,1083,.52795029,.49154928,,,0,0
2008,25,Massachusetts,Total,36920,28521,63550,48199,45807,17743,33816,14383,.72080255,.70159131,18326,13121,0,0
2008,25,Massachusetts,White,27630,21287,46927,35457,34739,12188,25793,9664,.74027747,.72744453,,,0,0
2008,26,Michigan,Asian,2803,2449,5806,5152,4399,1407,3911,1241,.7576645,.75912267,,,0,0
2008,26,Michigan,Black,1922,1768,2702,2458,850,1852,713,1745,.31458178,.29007322,,,0,0
2008,26,Michigan,Hispanic,960,853,1438,1271,798,640,687,584,.55493742,.5405193,,,0,0
2008,26,Michigan,Total,39743,34763,63554,55473,40642,22912,35029,20444,.63948768,.63146037,22495,14461,0,0
2008,26,Michigan,White,31782,27702,49899,43369,32404,17495,27865,15504,.64939177,.64250964,,,0,0
2008,27,Minnesota,Asian,1979,1751,3531,3148,2106,1425,1852,1296,.59643161,.58831006,,,0,0
2008,27,Minnesota,Black,652,592,975,874,338,637,281,593,.34666666,.32151029,,,0,0
2008,27,Minnesota,Hispanic,544,458,855,716,451,404,361,355,.52748537,.50418997,,,0,0
2008,27,Minnesota,Total,27605,24414,44281,38934,28138,16143,24444,14490,.63544184,.6278317,13473,8549,0,0
2008,27,Minnesota,White,23236,20564,37040,32557,24147,12893,21011,11546,.65191686,.64536047,,,0,0
2008,28,Mississippi,Asian,214,167,379,271,193,186,123,148,.50923485,.45387453,,,0,0
2008,28,Mississippi,Black,1592,1519,2361,2244,216,2145,183,2061,.091486655,.081550799,,,0,0
2008,28,Mississippi,Hispanic,107,96,137,121,31,106,28,93,.22627737,.23140496,,,0,0
2008,28,Mississippi,Total,5750,4768,8520,6896,2717,5803,1906,4990,.31889671,.2763921,3157,976,0,0
2008,28,Mississippi,White,3601,2784,5294,3969,2179,3115,1502,2467,.41159803,.37843284,,,0,0
2008,29,Missouri,Asian,800,629,1770,1385,1319,451,1033,352,.74519771,.74584836,,,0,0
2008,29,Missouri,Black,1176,1048,1655,1450,311,1344,198,1252,.18791541,.13655172,,,0,0
2008,29,Missouri,Hispanic,390,332,619,524,328,291,263,261,.5298869,.50190842,,,0,0
2008,29,Missouri,Total,14500,11182,24056,17951,15466,8590,10911,7040,.6429165,.60782129,6560,3927,0,0
2008,29,Missouri,White,11444,8646,18837,13732,12780,6057,8931,4801,.67845196,.6503787,,,0,0
2008,30,Montana,Asian,66,55,102,84,63,39,52,32,.61764705,.61904764,,,0,0
2008,30,Montana,Black,11,11,18,18,6,12,6,12,.33333334,.33333334,,,0,0
2008,30,Montana,Hispanic,42,36,68,61,38,30,36,25,.55882353,.59016395,,,0,0
2008,30,Montana,Total,2623,2407,4048,3751,2585,1463,2425,1326,.63858694,.64649427,1635,1088,0,0
2008,30,Montana,White,2398,2208,3700,3439,2390,1310,2247,1192,.64594597,.65338761,,,0,0
2008,31,Nebraska,Asian,216,190,411,366,238,173,207,159,.5790754,.56557375,,,0,0
2008,31,Nebraska,Black,109,100,161,149,60,101,59,90,.3726708,.39597315,,,0,0
2008,31,Nebraska,Hispanic,162,150,246,221,127,119,114,107,.51626015,.51583713,,,0,0
2008,31,Nebraska,Total,4251,3712,6933,6082,3809,3124,3249,2833,.5494014,.5341993,2228,1346,0,0
2008,31,Nebraska,White,3612,3137,5843,5100,3245,2598,2743,2357,.55536538,.53784311,,,0,0
2008,32,Nevada,Asian,1494,1385,2902,2658,1368,1534,1212,1446,.47139904,.45598194,,,0,0
2008,32,Nevada,Black,411,392,680,644,201,479,184,460,.29558823,.2857143,,,0,0
2008,32,Nevada,Hispanic,1572,1504,2435,2302,931,1504,861,1441,.38234085,.3740226,,,0,0
2008,32,Nevada,Total,9205,8513,16137,14672,7895,8242,7023,7649,.48924831,.47866684,4950,2716,0,0
2008,32,Nevada,White,5130,4678,9063,8102,4935,4128,4359,3743,.54452169,.53801531,,,0,0
2008,33,New Hampshire,Asian,417,172,767,307,598,169,217,90,.779661,.7068404,,,0,0
2008,33,New Hampshire,Black,46,19,65,26,39,26,15,11,.60000002,.57692307,,,0,0
2008,33,New Hampshire,Hispanic,113,78,164,113,123,41,80,33,.75,.7079646,,,0,0
2008,33,New Hampshire,Total,5642,4198,8758,6329,6318,2440,4500,1829,.72139758,.71101278,3068,2259,0,0
2008,33,New Hampshire,White,4810,3785,7320,5638,5222,2098,4015,1623,.71338797,.71213198,,,0,0
2008,34,New Jersey,Asian,7816,6984,16415,14716,12429,3986,11215,3501,.7571733,.76209569,,,0,0
2008,34,New Jersey,Black,2165,1808,3306,2769,1253,2053,981,1788,.37900788,.35427952,,,0,0
2008,34,New Jersey,Hispanic,4029,3452,6214,5289,3401,2813,2850,2439,.5473125,.53885424,,,0,0
2008,34,New Jersey,Total,45359,37120,82499,67404,57735,24764,47364,20040,.69982666,.70268828,23810,16999,0,0
2008,34,New Jersey,White,27973,22141,50417,39690,36435,13982,28940,10750,.72267288,.72915089,,,0,0
2008,35,New Mexico,Asian,258,220,526,454,286,240,226,228,.54372627,.49779737,,,0,0
2008,35,New Mexico,Black,126,118,197,183,64,133,52,131,.32487309,.28415301,,,0,0
2008,35,New Mexico,Hispanic,2527,2342,3686,3407,1171,2515,989,2418,.31768855,.29028469,,,0,0
2008,35,New Mexico,Total,6763,6037,10567,9441,4553,6014,3752,5689,.4308697,.39741552,3769,1740,0,0
2008,35,New Mexico,White,2949,2612,4835,4291,2566,2269,2112,2179,.53071356,.49219295,,,0,0
2008,36,New York,Asian,14178,12974,26792,24669,18441,8351,17042,7627,.68830246,.69082654,,,0,0
2008,36,New York,Black,8102,7032,11490,9981,3672,7818,2980,7001,.31958225,.29856727,,,0,0
2008,36,New York,Hispanic,12123,10189,17671,14899,8883,8788,7313,7586,.50268799,.49083832,,,0,0
2008,36,New York,Total,118645,101174,200609,171896,126169,74440,106912,64984,.62892991,.62195748,57334,37788,0,0
2008,36,New York,White,75250,63485,129320,109557,86242,43078,72363,37194,.66688836,.66050547,,,0,0
2008,37,North Carolina,Asian,2541,2330,5884,5435,3868,2016,3519,1916,.65737593,.64747012,,,0,0
2008,37,North Carolina,Black,4766,4617,7782,7537,2008,5774,1852,5685,.25803137,.2457211,,,0,0
2008,37,North Carolina,Hispanic,1656,1550,2982,2778,1551,1431,1399,1379,.52012074,.5035997,,,0,0
2008,37,North Carolina,Total,45704,40790,85378,76038,49508,35870,42733,33305,.57986838,.56199533,23629,14484,0,0
2008,37,North Carolina,White,34517,30303,64523,56544,39821,24702,34041,22503,.61715978,.60202676,,,0,0
2008,38,North Dakota,Asian,47,43,94,90,72,22,71,19,.76595747,.78888887,,,0,0
2008,38,North Dakota,Black,8,8,10,10,5,5,5,5,.5,.5,,,0,0
2008,38,North Dakota,Hispanic,6,5,7,5,4,3,3,2,.5714286,.60000002,,,0,0
2008,38,North Dakota,Total,1164,1082,1668,1559,1052,616,990,569,.63069546,.63502246,737,491,0,0
2008,38,North Dakota,White,1083,1008,1521,1421,949,572,890,531,.62393165,.62631947,,,0,0
2008,39,Ohio,Asian,2275,1896,4834,4026,3742,1092,3078,948,.77410012,.76453054,,,0,0
2008,39,Ohio,Black,2291,2014,3261,2865,1043,2218,824,2041,.31984055,.28760907,,,0,0
2008,39,Ohio,Hispanic,842,672,1342,1082,788,554,603,479,.5871833,.55730128,,,0,0
2008,39,Ohio,Total,42771,34366,69220,55164,44437,24783,34389,20775,.64196765,.62339568,21308,13102,0,0
2008,39,Ohio,White,35262,28099,56324,44434,36747,19577,28294,16140,.65242171,.63676465,,,0,0
2008,40,Oklahoma,Asian,877,820,1880,1746,959,921,863,883,.51010638,.49427262,,,0,0
2008,40,Oklahoma,Black,748,723,1142,1104,257,885,237,867,.22504379,.21467391,,,0,0
2008,40,Oklahoma,Hispanic,731,682,1138,1059,418,720,376,683,.36731106,.35505193,,,0,0
2008,40,Oklahoma,Total,13429,12321,22359,20411,10111,12248,8890,11521,.45221165,.43554947,7519,3632,0,0
2008,40,Oklahoma,White,9190,8354,15194,13730,7233,7961,6322,7408,.47604316,.46045157,,,0,0
2008,41,Oregon,Asian,1386,1193,2451,2182,1528,923,1340,842,.62341899,.61411548,,,0,0
2008,41,Oregon,Black,154,142,223,208,90,133,80,128,.40358743,.38461539,,,0,0
2008,41,Oregon,Hispanic,700,642,1001,908,417,584,377,531,.41658342,.41519824,,,0,0
2008,41,Oregon,Total,12441,11017,19232,17023,11567,7665,10003,7020,.6014455,.58761674,6912,4260,0,0
2008,41,Oregon,White,9418,8367,14365,12716,8831,5534,7637,5079,.61475807,.60058194,,,0,0
2008,42,Pennsylvania,Asian,3455,2775,6750,5529,4773,1977,3944,1585,.70711112,.71332973,,,0,0
2008,42,Pennsylvania,Black,2172,1881,2909,2491,727,2182,532,1959,.24991407,.21356885,,,0,0
2008,42,Pennsylvania,Hispanic,1133,935,1720,1414,928,792,727,687,.53953487,.51414424,,,0,0
2008,42,Pennsylvania,Total,45588,36589,74538,59274,49369,25169,39052,20222,.66233331,.65883863,23700,15722,0,0
2008,42,Pennsylvania,White,36846,29451,59777,47244,40793,18984,32253,14991,.68241966,.68268985,,,0,0
2008,44,Rhode Island,Asian,218,127,443,251,319,124,163,88,.72009027,.64940238,,,0,0
2008,44,Rhode Island,Black,65,41,96,52,46,50,20,32,.47916666,.38461539,,,0,0
2008,44,Rhode Island,Hispanic,193,142,276,189,129,147,70,119,.46739131,.37037036,,,0,0
2008,44,Rhode Island,Total,3906,2489,6610,3876,4306,2304,2329,1547,.65143722,.60087717,1555,991,0,0
2008,44,Rhode Island,White,3168,2011,5300,3086,3508,1792,1908,1178,.66188681,.61827606,,,0,0
2008,45,South Carolina,Asian,692,617,1383,1250,943,440,858,392,.68185103,.6864,,,1,1
2008,45,South Carolina,Black,2258,2213,3299,3227,912,2387,886,2341,.27644742,.27455842,,,1,1
2008,45,South Carolina,Hispanic,451,418,727,664,421,306,374,290,.57909214,.56325299,,,1,1
2008,45,South Carolina,Total,16454,14787,26872,23903,15362,11510,13435,10468,.5716731,.56206334,8182,4881,1,1
2008,45,South Carolina,White,12293,10831,20261,17653,12428,7833,10723,6930,.61339521,.60743219,,,1,1
2008,46,South Dakota,Asian,60,53,132,122,96,36,89,33,.72727275,.72950822,,,0,0
2008,46,South Dakota,Black,10,9,12,11,1,11,1,10,.083333336,.090909094,,,0,0
2008,46,South Dakota,Hispanic,24,18,40,33,28,12,23,10,.69999999,.69696969,,,0,0
2008,46,South Dakota,Total,2113,1896,3418,3091,2110,1308,1940,1151,.61732006,.62762862,1339,812,0,0
2008,46,South Dakota,White,1919,1755,3091,2831,1926,1165,1778,1053,.62309933,.62804663,,,0,0
2008,47,Tennessee,Asian,1084,859,2360,1866,1574,786,1196,670,.66694915,.64094317,,,0,0
2008,47,Tennessee,Black,2185,2020,3101,2838,858,2243,721,2117,.27668494,.25405216,,,0,0
2008,47,Tennessee,Hispanic,508,439,826,709,432,394,359,350,.52300245,.50634694,,,0,0
2008,47,Tennessee,Total,18396,13883,30797,22638,18516,12281,12532,10106,.6012274,.55358249,8505,4768,0,0
2008,47,Tennessee,White,13981,10126,23395,16481,14996,8399,9874,6607,.64099169,.59911412,,,0,0
2008,48,Texas,Asian,13918,13206,32393,30908,19821,12572,18746,12162,.61189145,.60650963,,,0,0
2008,48,Texas,Black,10261,9966,16791,16328,3747,13044,3496,12832,.22315526,.21411073,,,0,0
2008,48,Texas,Hispanic,49135,47279,80009,77021,26190,53819,24563,52458,.32733819,.31891301,,,0,0
2008,48,Texas,Total,147241,137947,270466,253518,125779,144687,114268,139250,.46504551,.45072934,72896,38526,0,0
2008,48,Texas,White,67140,61273,128608,117642,70245,58363,62403,55239,.54619461,.53044832,,,0,0
2008,49,Utah,Asian,778,683,1433,1251,908,525,799,452,.6336357,.63868904,,,0,0
2008,49,Utah,Black,69,59,94,80,47,47,40,40,.5,.5,,,0,0
2008,49,Utah,Hispanic,768,715,1124,1042,577,547,536,506,.51334518,.51439542,,,0,0
2008,49,Utah,Total,15599,14683,24974,23403,16131,8843,15142,8261,.64591175,.64701104,8914,6085,0,0
2008,49,Utah,White,13275,12577,21209,20025,13975,7234,13209,6816,.65891838,.65962547,,,0,0
2008,50,Vermont,Asian,153,83,313,191,194,119,128,63,.61980832,.67015707,,,0,0
2008,50,Vermont,Black,23,19,36,29,17,19,13,16,.47222221,.44827586,,,0,0
2008,50,Vermont,Hispanic,41,36,72,64,49,23,43,21,.68055558,.671875,,,0,0
2008,50,Vermont,Total,3355,2920,5468,4775,3581,1887,3103,1672,.65490127,.64984292,2049,1401,0,0
2008,50,Vermont,White,2989,2665,4805,4303,3157,1648,2797,1506,.65702391,.6500116,,,0,0
2008,51,Virginia,Asian,7022,6558,14842,13857,9036,5806,8395,5462,.60881281,.60583097,,,0,0
2008,51,Virginia,Black,5557,5316,8382,7988,2763,5619,2542,5446,.32963493,.31822735,,,0,0
2008,51,Virginia,Hispanic,3319,3096,5496,5100,2919,2577,2658,2442,.53111356,.52117646,,,0,0
2008,51,Virginia,Total,59762,54155,108076,97423,63759,44317,56687,40736,.58994597,.58186466,27460,17199,0,0
2008,51,Virginia,White,39283,34970,71069,62852,44292,26777,38770,24082,.62322533,.61684591,,,0,0
2008,53,Washington,Asian,4867,4479,9097,8432,5220,3877,4769,3663,.57381552,.56558347,,,0,0
2008,53,Washington,Black,690,633,1004,916,342,662,288,628,.34063745,.31441048,,,0,0
2008,53,Washington,Hispanic,1890,1791,2763,2605,1172,1591,1076,1529,.42417663,.41305181,,,0,0
2008,53,Washington,Total,31237,28233,51235,46372,30175,21060,26730,19642,.58895284,.57642543,16268,10073,0,0
2008,53,Washington,White,21457,19230,34501,30908,21347,13154,18756,12152,.61873567,.60683316,,,0,0
2008,54,West Virginia,Asian,159,129,366,306,240,126,198,108,.6557377,.64705884,,,0,0
2008,54,West Virginia,Black,69,63,103,91,33,70,30,61,.32038835,.32967034,,,0,0
2008,54,West Virginia,Hispanic,65,59,113,100,50,63,41,59,.44247788,.41,,,0,0
2008,54,West Virginia,Total,4918,4627,7778,7250,3300,4478,2955,4295,.42427358,.40758622,2656,1199,0,0
2008,54,West Virginia,White,4432,4198,6872,6454,2845,4027,2568,3886,.41399884,.39789277,,,0,0
2008,55,Wisconsin,Asian,1126,997,2099,1862,1385,714,1238,624,.65983802,.66487646,,,0,0
2008,55,Wisconsin,Black,569,487,796,698,247,549,218,480,.31030151,.31232092,,,0,0
2008,55,Wisconsin,Hispanic,738,635,1099,962,592,507,507,455,.53867149,.52702701,,,0,0
2008,55,Wisconsin,Total,26593,24209,42450,38720,28531,13919,25905,12815,.67210835,.66903406,15644,10704,0,0
2008,55,Wisconsin,White,23220,21244,36882,33793,25275,11607,23027,10766,.68529361,.68141329,,,0,0
2008,56,Wyoming,Asian,34,34,59,59,28,31,28,31,.47457626,.47457626,,,0,0
2008,56,Wyoming,Black,7,7,9,9,2,7,2,7,.22222222,.22222222,,,0,0
2008,56,Wyoming,Hispanic,47,46,66,65,24,42,23,42,.36363637,.35384616,,,0,0
2008,56,Wyoming,Total,1073,1069,1599,1592,756,843,750,842,.47279549,.47110552,809,408,0,0
2008,56,Wyoming,White,947,944,1405,1399,681,724,676,723,.48469752,.48320228,,,0,0
2009,1,Alabama,Asian,657,568,1489,1302,1007,482,876,426,.67629284,.67281103,,,0,0
2009,1,Alabama,Black,2086,2035,3098,3030,588,2510,549,2481,.18979988,.18118812,,,0,0
2009,1,Alabama,Hispanic,303,261,515,439,253,262,194,245,.49126214,.44191343,,,0,0
2009,1,Alabama,Total,13008,11008,22253,18963,10990,11263,8789,10174,.493866,.46348152,6462,2972,0,0
2009,1,Alabama,White,9448,7728,16332,13527,8740,7592,6873,6654,.5351457,.50809491,,,0,0
2009,2,Alaska,Asian,276,270,525,519,279,246,276,243,.53142858,.53179193,,,0,0
2009,2,Alaska,Black,53,53,75,75,35,40,35,40,.46666667,.46666667,,,0,0
2009,2,Alaska,Hispanic,93,89,140,136,69,71,67,69,.49285713,.49264705,,,0,0
2009,2,Alaska,Total,2587,2511,4272,4179,2658,1614,2593,1586,.62219101,.6204834,1556,982,0,0
2009,2,Alaska,White,1873,1822,3068,3004,2011,1057,1963,1041,.65547585,.65346205,,,0,0
2009,4,Arizona,Asian,1952,1791,4104,3771,2670,1434,2443,1328,.65058482,.64783877,,,0,0
2009,4,Arizona,Black,702,659,1112,1037,396,716,361,676,.3561151,.34811959,,,0,0
2009,4,Arizona,Hispanic,5266,4921,7846,7282,3068,4778,2733,4549,.39102727,.37530899,,,0,0
2009,4,Arizona,Total,22154,19938,36754,32754,20295,16459,17760,14994,.55218482,.54222387,11367,6484,0,0
2009,4,Arizona,White,12519,11023,20948,18239,12847,8101,11112,7127,.61328048,.60924393,,,0,0
2009,5,Arkansas,Asian,631,571,1384,1263,567,817,526,737,.4096821,.41646874,,,1,1
2009,5,Arkansas,Black,2567,2533,3821,3776,325,3496,305,3471,.085056268,.080773301,,,1,1
2009,5,Arkansas,Hispanic,939,930,1459,1446,434,1025,427,1019,.29746401,.29529738,,,1,1
2009,5,Arkansas,Total,19115,18435,31232,30112,9281,21951,8654,21458,.29716316,.28739372,9973,3210,1,1
2009,5,Arkansas,White,14101,13558,23114,22234,7503,15611,6982,15252,.32460847,.31402355,,,1,1
2009,6,California,Asian,66430,60097,136787,123775,88782,48005,79615,44160,.64905292,.64322358,,,0,0
2009,6,California,Black,8515,7499,13773,12106,5173,8600,4217,7889,.37558994,.34833968,,,0,0
2009,6,California,Hispanic,75357,70118,123346,114673,55163,68183,49753,64920,.44722164,.43386847,,,0,0
2009,6,California,Total,264225,231632,479180,418461,287560,191620,244262,174199,.6001085,.58371508,124076,80710,0,0
2009,6,California,White,88010,72258,159059,129644,110886,48173,88734,40910,.69713753,.68444353,,,0,0
2009,8,Colorado,Asian,1770,1652,3403,3161,2031,1372,1874,1287,.59682631,.59285039,,,0,0
2009,8,Colorado,Black,982,947,1457,1407,469,988,436,971,.32189432,.30987918,,,0,0
2009,8,Colorado,Hispanic,3366,3228,4921,4708,1925,2996,1802,2906,.39118066,.38275278,,,0,0
2009,8,Colorado,Total,29486,27525,49188,45785,29749,19439,27354,18431,.60480201,.59744459,15498,9475,0,0
2009,8,Colorado,White,21535,20008,36427,33787,23670,12757,21774,12013,.64979273,.64444906,,,0,0
2009,9,Connecticut,Asian,2015,1376,4257,2816,3353,904,2145,671,.78764391,.76171875,,,0,0
2009,9,Connecticut,Black,1046,842,1633,1309,593,1040,371,938,.36313534,.28342247,,,0,0
2009,9,Connecticut,Hispanic,1467,1211,2253,1828,1320,933,1013,815,.58588547,.55415756,,,0,0
2009,9,Connecticut,Total,23445,18123,41521,31262,30508,11013,22304,8958,.7347607,.71345401,11186,8017,0,0
2009,9,Connecticut,White,17429,13609,30845,23495,23474,7371,17568,5927,.76103097,.74773353,,,0,0
2009,10,Delaware,Asian,431,340,1005,816,708,297,571,245,.70447761,.69975489,,,0,0
2009,10,Delaware,Black,433,383,678,604,236,442,193,411,.3480826,.31953642,,,0,0
2009,10,Delaware,Hispanic,192,154,343,271,170,173,118,153,.49562684,.43542436,,,0,0
2009,10,Delaware,Total,4827,3370,8645,6068,5226,3419,3250,2818,.60451126,.53559655,2050,1083,0,0
2009,10,Delaware,White,3528,2311,6207,4061,3898,2309,2232,1829,.62800062,.5496183,,,0,0
2009,11,District Of Columbia,Asian,164,75,368,148,234,134,47,101,.63586956,.31756756,,,0,0
2009,11,District Of Columbia,Black,1616,1373,2307,1910,438,1869,199,1711,.18985696,.10418848,,,0,0
2009,11,District Of Columbia,Hispanic,467,346,786,529,302,484,102,427,.38422391,.19281663,,,0,0
2009,11,District Of Columbia,Total,4154,2208,7466,3547,4086,3380,897,2650,.54728103,.25288975,1029,233,0,0
2009,11,District Of Columbia,White,1498,249,3262,667,2630,632,442,225,.80625385,.66266865,,,0,0
2009,12,Florida,Asian,8923,8206,19122,17557,9744,9378,8653,8904,.50957012,.49285185,,,0,1
2009,12,Florida,Black,17832,17422,28602,27853,5737,22865,5328,22525,.20058037,.19128999,,,0,1
2009,12,Florida,Hispanic,33893,30294,59106,52412,26577,32529,22132,30280,.44964978,.4222697,,,0,1
2009,12,Florida,Total,145389,131826,260162,233857,118166,141996,100356,133501,.45420161,.42913404,58251,30803,0,1
2009,12,Florida,White,73926,66058,134687,119233,68314,66373,57652,61581,.50720561,.48352385,,,0,1
2009,13,Georgia,Asian,5992,5538,12425,11449,7941,4484,7237,4212,.63911468,.63210762,,,0,0
2009,13,Georgia,Black,12301,11871,17487,16818,4558,12929,4197,12621,.26065078,.24955405,,,0,0
2009,13,Georgia,Hispanic,3507,3228,5443,4936,2681,2762,2299,2637,.49255925,.46576175,,,0,0
2009,13,Georgia,Total,63824,56738,104502,91864,56416,48086,47491,44373,.53985572,.51697075,27432,14520,0,0
2009,13,Georgia,White,38010,32428,62775,52886,38168,24607,31129,21757,.60801274,.5886057,,,0,0
2009,15,Hawaii,Asian,3803,2162,6185,3353,3427,2758,1378,1975,.55408245,.41097525,,,0,0
2009,15,Hawaii,Black,77,63,129,109,56,73,42,67,.43410853,.38532111,,,0,0
2009,15,Hawaii,Hispanic,144,97,218,144,105,113,54,90,.48165137,.375,,,0,0
2009,15,Hawaii,Total,5677,3203,9206,4954,5181,4025,2069,2885,.56278515,.4176423,2130,964,0,0
2009,15,Hawaii,White,951,517,1616,854,1002,614,410,444,.62004948,.48009369,,,0,0
2009,16,Idaho,Asian,154,145,308,296,219,89,208,88,.71103895,.7027027,,,0,0
2009,16,Idaho,Black,28,28,46,46,19,27,19,27,.41304347,.41304347,,,0,0
2009,16,Idaho,Hispanic,184,178,315,301,166,149,156,145,.52698416,.5182724,,,0,0
2009,16,Idaho,Total,4313,4178,7044,6839,4843,2201,4693,2146,.68753546,.68621141,2623,1732,0,0
2009,16,Idaho,White,3759,3647,6050,5884,4228,1822,4111,1773,.698843,.69867438,,,0,0
2009,17,Illinois,Asian,7180,6666,15316,14348,11392,3924,10731,3617,.74379736,.74790913,,,0,0
2009,17,Illinois,Black,6277,5936,9128,8555,2086,7042,1821,6734,.22852761,.21285798,,,0,0
2009,17,Illinois,Hispanic,8508,7647,13034,11813,5872,7162,5203,6610,.45051405,.44044697,,,0,0
2009,17,Illinois,Total,65651,57805,114894,101347,76631,38263,67177,34170,.66697127,.6628415,32940,21429,0,0
2009,17,Illinois,White,39788,34134,70899,60906,53150,17749,45813,15093,.74965799,.7521919,,,0,0
2009,18,Indiana,Asian,1327,1117,2665,2216,1811,854,1467,749,.67954969,.66200364,,,1,1
2009,18,Indiana,Black,1246,1107,1776,1566,402,1374,318,1248,.22635135,.20306513,,,1,1
2009,18,Indiana,Hispanic,915,816,1340,1178,534,806,437,741,.39850748,.37096775,,,1,1
2009,18,Indiana,Total,27683,24360,42899,37109,20893,22006,17261,19848,.48702767,.46514323,13098,6591,1,1
2009,18,Indiana,White,22950,20211,35118,30389,17168,17950,14220,16169,.48886612,.46793246,,,1,1
2009,19,Iowa,Asian,421,393,815,775,611,204,589,186,.74969327,.75999999,,,0,0
2009,19,Iowa,Black,137,133,207,202,103,104,101,101,.49758455,.5,,,0,0
2009,19,Iowa,Hispanic,238,229,322,310,157,165,150,160,.48757765,.48387095,,,0,0
2009,19,Iowa,Total,8298,7723,12512,11706,8210,4302,7706,4000,.65617007,.65829492,4687,2929,0,0
2009,19,Iowa,White,7140,6628,10604,9890,6977,3627,6525,3365,.65795928,.65975732,,,0,0
2009,20,Kansas,Asian,613,575,1100,1025,691,409,639,386,.62818182,.62341464,,,0,0
2009,20,Kansas,Black,328,325,439,432,127,312,123,309,.28929386,.28472221,,,0,0
2009,20,Kansas,Hispanic,520,499,714,684,323,391,298,386,.45238096,.43567252,,,0,0
2009,20,Kansas,Total,8193,7758,12251,11578,7473,4778,6995,4583,.60999101,.60416305,4638,2706,0,0
2009,20,Kansas,White,6292,5935,9375,8838,5992,3383,5608,3230,.63914669,.63453269,,,0,0
2009,21,Kentucky,Asian,767,693,1574,1428,1026,548,928,500,.65184242,.64985996,,,0,1
2009,21,Kentucky,Black,843,814,1249,1206,388,861,370,836,.31064853,.30679932,,,0,1
2009,21,Kentucky,Hispanic,417,388,669,611,299,370,267,344,.44693571,.43698853,,,0,1
2009,21,Kentucky,Total,19440,16988,31531,27167,16035,15496,13192,13975,.50854713,.48558915,8833,4369,0,1
2009,21,Kentucky,White,16599,14398,26672,22784,13611,13061,11079,11705,.51031041,.48626229,,,0,1
2009,22,Louisiana,Asian,498,394,891,693,554,337,411,282,.6217733,.59307361,,,0,0
2009,22,Louisiana,Black,1067,952,1424,1247,304,1120,233,1014,.21348314,.18684843,,,0,0
2009,22,Louisiana,Hispanic,273,154,412,218,219,193,92,126,.53155339,.42201835,,,0,0
2009,22,Louisiana,Total,7106,4568,10395,6397,5359,5036,2772,3625,.51553631,.43332812,2837,1241,0,0
2009,22,Louisiana,White,4901,2810,7122,3871,4022,3100,1890,1981,.56472903,.48824593,,,0,0
2009,23,Maine,Asian,398,330,744,621,414,330,355,266,.55645162,.57165861,,,0,0
2009,23,Maine,Black,57,49,93,78,39,54,29,49,.41935483,.37179488,,,0,0
2009,23,Maine,Hispanic,94,89,149,143,71,78,67,76,.47651008,.46853146,,,0,0
2009,23,Maine,Total,7803,7247,12483,11470,7246,5237,6609,4861,.58046943,.57619876,3951,2307,0,0
2009,23,Maine,White,6959,6509,11040,10212,6474,4566,5934,4278,.58641303,.58108109,,,0,0
2009,24,Maryland,Asian,6163,5731,14172,13255,10251,3921,9585,3670,.7233277,.72312337,,,0,0
2009,24,Maryland,Black,8636,8076,13619,12723,4098,9521,3614,9109,.30090314,.28405249,,,0,0
2009,24,Maryland,Hispanic,3273,3024,5577,5117,3023,2554,2717,2400,.54204768,.53097516,,,0,0
2009,24,Maryland,Total,52456,45897,97147,85173,60814,36333,52128,33045,.62599975,.61202496,23293,14455,0,0
2009,24,Maryland,White,30716,25895,57298,48480,39684,17614,33090,15390,.69258964,.68254948,,,0,0
2009,25,Massachusetts,Asian,4338,3220,8915,6557,6777,2138,4869,1688,.76017946,.74256521,,,0,0
2009,25,Massachusetts,Black,1543,1271,2342,1927,827,1515,586,1341,.35311699,.30409965,,,0,0
2009,25,Massachusetts,Hispanic,2138,1795,3229,2704,1517,1712,1174,1530,.46980488,.43417159,,,0,0
2009,25,Massachusetts,Total,38579,29980,66772,51011,48121,18651,35808,15203,.7206763,.70196623,19071,13634,0,0
2009,25,Massachusetts,White,27827,21648,47482,36290,35667,11815,26888,9402,.75116885,.74092036,,,0,0
2009,26,Michigan,Asian,3171,2782,6555,5730,5008,1547,4369,1361,.76399696,.76247817,,,0,0
2009,26,Michigan,Black,2140,1958,2857,2589,866,1991,720,1869,.30311516,.27809966,,,0,0
2009,26,Michigan,Hispanic,1095,974,1649,1467,884,765,767,700,.53608245,.52283573,,,0,0
2009,26,Michigan,Total,42288,37392,67128,59067,43899,23229,38161,20906,.65395957,.64606297,23348,14873,0,0
2009,26,Michigan,White,33376,29456,52091,45780,34742,17349,30248,15532,.6669482,.66072524,,,0,0
2009,27,Minnesota,Asian,2272,1996,4198,3714,2494,1704,2186,1528,.59409243,.58858371,,,0,0
2009,27,Minnesota,Black,775,698,1104,995,398,706,343,652,.36050725,.34472361,,,0,0
2009,27,Minnesota,Hispanic,616,523,979,823,516,463,413,410,.52706844,.50182259,,,0,0
2009,27,Minnesota,Total,30392,26894,49497,43480,31740,17757,27662,15818,.64125097,.63620055,14396,9111,0,0
2009,27,Minnesota,White,25181,22326,40742,35838,26854,13888,23502,12336,.65912324,.65578437,,,0,0
2009,28,Mississippi,Asian,225,173,439,322,243,196,165,157,.55353075,.51242238,,,0,0
2009,28,Mississippi,Black,1534,1489,2110,2033,250,1860,212,1821,.11848341,.10427939,,,0,0
2009,28,Mississippi,Hispanic,96,84,163,146,57,106,51,95,.34969324,.34931508,,,0,0
2009,28,Mississippi,Total,5765,4831,8405,6868,3030,5375,2220,4648,.36049971,.32323819,3282,1019,0,0
2009,28,Mississippi,White,3665,2874,5322,4051,2348,2974,1692,2359,.44118753,.41767466,,,0,0
2009,29,Missouri,Asian,908,718,1951,1468,1438,513,1066,402,.73705792,.72615802,,,0,0
2009,29,Missouri,Black,1524,1391,2131,1930,379,1752,287,1643,.17785077,.14870466,,,0,0
2009,29,Missouri,Hispanic,428,364,643,537,326,317,248,289,.50699842,.46182495,,,0,0
2009,29,Missouri,Total,16215,12874,26355,20214,16729,9626,12016,8198,.63475621,.59443951,7649,4388,0,0
2009,29,Missouri,White,12581,9786,20428,15379,13895,6533,9946,5433,.68019384,.64672607,,,0,0
2009,30,Montana,Asian,52,48,90,85,58,32,55,30,.64444447,.64705884,,,0,0
2009,30,Montana,Black,16,16,25,25,17,8,17,8,.68000001,.68000001,,,0,0
2009,30,Montana,Hispanic,46,41,80,73,51,29,47,26,.63749999,.6438356,,,0,0
2009,30,Montana,Total,2650,2461,4084,3814,2680,1404,2515,1299,.65621936,.65941268,1661,1066,0,0
2009,30,Montana,White,2412,2240,3717,3469,2461,1256,2308,1161,.6620931,.66532141,,,0,0
2009,31,Nebraska,Asian,250,210,512,443,331,181,284,159,.64648438,.64108354,,,0,0
2009,31,Nebraska,Black,103,93,167,154,56,111,51,103,.33532935,.33116883,,,0,0
2009,31,Nebraska,Hispanic,184,165,311,282,137,174,121,161,.44051448,.42907801,,,0,0
2009,31,Nebraska,Total,4539,3955,7574,6698,4315,3259,3731,2967,.56971216,.55703193,2566,1442,0,0
2009,31,Nebraska,White,3824,3325,6253,5519,3607,2646,3115,2404,.57684314,.56441385,,,0,0
2009,32,Nevada,Asian,1820,1718,3558,3318,1630,1928,1485,1833,.45812255,.44755876,,,0,0
2009,32,Nevada,Black,528,507,904,872,252,652,240,632,.27876106,.27522936,,,0,0
2009,32,Nevada,Hispanic,2005,1932,3256,3110,1090,2166,1007,2103,.3347666,.32379422,,,0,0
2009,32,Nevada,Total,10591,9902,18631,17276,8724,9907,7937,9339,.46825182,.45942348,5582,3023,0,0
2009,32,Nevada,White,5495,5054,9632,8801,5179,4453,4694,4107,.53768688,.5333485,,,0,0
2009,33,New Hampshire,Asian,457,196,877,355,691,186,265,90,.78791332,.74647886,,,0,0
2009,33,New Hampshire,Black,62,29,88,38,45,43,18,20,.51136363,.47368422,,,0,0
2009,33,New Hampshire,Hispanic,104,77,167,116,119,48,82,34,.71257484,.70689654,,,0,0
2009,33,New Hampshire,Total,5902,4396,9335,6702,6736,2599,4803,1899,.72158545,.71665174,3082,2260,0,0
2009,33,New Hampshire,White,4968,3931,7703,5937,5489,2214,4239,1698,.71257949,.71399695,,,0,0
2009,34,New Jersey,Asian,8312,7379,17910,15935,14032,3878,12566,3369,.7834729,.78857863,,,0,0
2009,34,New Jersey,Black,2345,1966,3489,2919,1388,2101,1066,1853,.39782172,.36519355,,,0,0
2009,34,New Jersey,Hispanic,4418,3840,6754,5828,3723,3031,3158,2670,.55122888,.54186684,,,0,0
2009,34,New Jersey,Total,46938,38687,85483,70307,61235,24248,50448,19859,.71634126,.71753877,24485,17522,0,0
2009,34,New Jersey,White,28236,22496,50878,40334,37637,13241,30068,10266,.73974997,.74547529,,,0,0
2009,35,New Mexico,Asian,298,254,559,471,349,210,271,200,.62432915,.57537156,,,0,0
2009,35,New Mexico,Black,144,131,223,207,72,151,61,146,.32286996,.29468599,,,0,0
2009,35,New Mexico,Hispanic,2965,2725,4224,3870,1424,2800,1187,2683,.33712122,.30671835,,,0,0
2009,35,New Mexico,Total,7536,6671,11486,10157,4952,6534,3996,6161,.43113357,.39342326,3771,1661,0,0
2009,35,New Mexico,White,3202,2781,5176,4499,2713,2463,2172,2327,.52414989,.48277396,,,0,0
2009,36,New York,Asian,14886,13591,28297,25966,19765,8532,18168,7798,.69848394,.6996842,,,0,0
2009,36,New York,Black,8909,7793,12893,11297,4375,8518,3580,7717,.33933142,.31689829,,,0,0
2009,36,New York,Hispanic,13021,11133,19311,16518,9980,9331,8358,8160,.51680392,.50599349,,,0,0
2009,36,New York,Total,122790,105008,208385,179396,134841,73544,114864,64532,.64707631,.64028186,58710,38016,0,0
2009,36,New York,White,75879,63945,131087,111323,90626,40461,76349,34974,.69134241,.6858331,,,0,0
2009,37,North Carolina,Asian,2800,2558,6542,6022,4316,2226,3900,2122,.65973711,.64762539,,,0,0
2009,37,North Carolina,Black,5255,5077,8611,8285,2385,6226,2199,6086,.27697131,.26541942,,,0,0
2009,37,North Carolina,Hispanic,2109,1951,3738,3446,1864,1874,1660,1786,.49866238,.48171794,,,0,0
2009,37,North Carolina,Total,47576,42309,89344,79143,52588,36756,45073,34070,.58860135,.56951344,24422,14648,0,0
2009,37,North Carolina,White,34777,30385,65584,57095,41323,24261,35033,22062,.63007748,.61359137,,,0,0
2009,38,North Dakota,Asian,55,43,86,70,66,20,52,18,.76744187,.74285716,,,0,0
2009,38,North Dakota,Black,4,4,4,4,2,2,3,1,.5,.75,,,0,0
2009,38,North Dakota,Hispanic,11,10,15,14,8,7,7,7,.53333336,.5,,,0,0
2009,38,North Dakota,Total,1152,1042,1536,1402,970,566,889,513,.63151044,.63409418,735,448,0,0
2009,38,North Dakota,White,1046,952,1386,1273,872,514,806,467,.6291486,.63315004,,,0,0
2009,39,Ohio,Asian,2432,1974,5264,4290,4055,1209,3309,981,.77032673,.77132869,,,0,0
2009,39,Ohio,Black,2460,2160,3547,3118,1215,2332,979,2139,.34254301,.31398332,,,0,0
2009,39,Ohio,Hispanic,869,700,1397,1123,852,545,649,474,.6098783,.57791632,,,0,0
2009,39,Ohio,Total,44630,36074,73324,58779,48321,25003,37806,20973,.6590066,.64318889,22123,13663,0,0
2009,39,Ohio,White,36431,29339,59173,47249,39684,19489,31070,16179,.67064369,.65758008,,,0,0
2009,40,Oklahoma,Asian,897,832,1910,1784,1010,900,920,864,.52879584,.5156951,,,0,0
2009,40,Oklahoma,Black,824,800,1240,1208,289,951,273,935,.23306452,.22599338,,,0,0
2009,40,Oklahoma,Hispanic,866,797,1352,1244,544,808,489,755,.40236688,.39308682,,,0,0
2009,40,Oklahoma,Total,13736,12591,22996,20979,11031,11965,9719,11260,.47969213,.46327281,7313,3526,0,0
2009,40,Oklahoma,White,9184,8333,15365,13845,7888,7477,6883,6962,.51337457,.49714699,,,0,0
2009,41,Oregon,Asian,1418,1225,2525,2233,1595,930,1376,857,.63168317,.61621135,,,0,0
2009,41,Oregon,Black,217,197,315,289,109,206,91,198,.34603176,.31487888,,,0,0
2009,41,Oregon,Hispanic,885,842,1300,1236,535,765,490,746,.41153845,.39644012,,,0,0
2009,41,Oregon,Total,12807,11466,19944,17931,12255,7689,10729,7202,.61447054,.59834921,6916,4305,0,0
2009,41,Oregon,White,9428,8448,14467,12991,9180,5287,8055,4936,.63454759,.62004465,,,0,0
2009,42,Pennsylvania,Asian,3671,2925,7395,5933,5284,2111,4315,1618,.71453685,.72728807,,,0,0
2009,42,Pennsylvania,Black,2551,2242,3544,3080,841,2703,623,2457,.23730248,.20227273,,,0,0
2009,42,Pennsylvania,Hispanic,1333,1101,2092,1715,1130,962,883,832,.54015297,.5148688,,,0,0
2009,42,Pennsylvania,Total,47802,38874,78416,63131,52666,25750,42095,21036,.67162311,.6667881,24606,16154,0,0
2009,42,Pennsylvania,White,37947,30762,61630,49441,43015,18615,34434,15007,.69795555,.69646651,,,0,0
2009,44,Rhode Island,Asian,240,130,477,236,334,143,152,84,.70020962,.64406782,,,0,0
2009,44,Rhode Island,Black,90,61,143,90,64,79,33,57,.44755244,.36666667,,,0,0
2009,44,Rhode Island,Hispanic,195,151,296,211,137,159,82,129,.46283785,.38862559,,,0,0
2009,44,Rhode Island,Total,4088,2600,7028,4181,4544,2484,2428,1753,.64655662,.58072233,1764,1092,0,0
2009,44,Rhode Island,White,3254,2076,5610,3373,3687,1923,2008,1365,.65721923,.59531575,,,0,0
2009,45,South Carolina,Asian,760,680,1512,1358,1041,471,925,433,.68849206,.68114877,,,1,1
2009,45,South Carolina,Black,2482,2437,3567,3484,1056,2511,1012,2472,.29604709,.29047072,,,1,1
2009,45,South Carolina,Hispanic,481,452,747,691,392,355,352,339,.52476573,.50940669,,,1,1
2009,45,South Carolina,Total,18001,16352,29400,26422,16987,12413,14953,11469,.57778913,.56592989,9175,5233,1,1
2009,45,South Carolina,White,13394,11962,22184,19622,13709,8475,11963,7659,.6179679,.60967284,,,1,1
2009,46,South Dakota,Asian,68,61,143,130,113,30,105,25,.79020977,.80769229,,,0,0
2009,46,South Dakota,Black,22,21,36,35,13,23,13,22,.3611111,.37142858,,,0,0
2009,46,South Dakota,Hispanic,41,38,67,61,31,36,27,34,.46268657,.44262296,,,0,0
2009,46,South Dakota,Total,2172,2003,3702,3449,2373,1329,2212,1237,.64100486,.64134532,1326,859,0,0
2009,46,South Dakota,White,1958,1816,3324,3113,2143,1181,2004,1109,.64470518,.64375198,,,0,0
2009,47,Tennessee,Asian,1125,887,2454,1982,1692,762,1335,647,.68948656,.67356205,,,0,0
2009,47,Tennessee,Black,2482,2306,3491,3210,860,2631,717,2493,.24634776,.22336449,,,0,0
2009,47,Tennessee,Hispanic,560,488,853,736,472,381,389,347,.55334115,.52853262,,,0,0
2009,47,Tennessee,Total,19463,14961,32231,24210,19248,12983,13355,10855,.59718907,.55163157,9140,4835,0,0
2009,47,Tennessee,White,14404,10600,23977,17211,15402,8575,10386,6825,.64236557,.60345125,,,0,0
2009,48,Texas,Asian,15415,14603,35230,33541,22123,13107,20875,12666,.62795913,.62237263,,,0,0
2009,48,Texas,Black,11482,11128,18635,18084,4408,14227,4100,13984,.23654413,.22671975,,,0,0
2009,48,Texas,Hispanic,55864,54048,90248,87209,30470,59778,28569,58640,.33762521,.32759234,,,0,0
2009,48,Texas,Total,158993,149174,287756,269799,138276,149480,125257,144542,.48053211,.46426043,76699,39772,0,0
2009,48,Texas,White,68289,62118,129361,117948,74572,54789,65951,51997,.5764643,.5591532,,,0,0
2009,49,Utah,Asian,818,708,1496,1289,935,561,821,468,.625,.63692784,,,0,0
2009,49,Utah,Black,88,77,132,109,58,74,48,61,.43939394,.44036698,,,0,0
2009,49,Utah,Hispanic,850,785,1259,1159,687,572,624,535,.54567116,.53839517,,,0,0
2009,49,Utah,Total,16361,15385,26084,24356,17057,9027,15891,8465,.65392578,.65244704,9192,6141,0,0
2009,49,Utah,White,13727,13005,21893,20608,14600,7293,13691,6917,.66687983,.66435367,,,0,0
2009,50,Vermont,Asian,169,70,324,148,211,113,117,31,.65123457,.79054052,,,0,0
2009,50,Vermont,Black,27,23,38,32,21,17,19,13,.55263156,.59375,,,0,0
2009,50,Vermont,Hispanic,39,28,55,39,36,19,27,12,.65454543,.69230771,,,0,0
2009,50,Vermont,Total,3495,2987,5752,4898,3831,1921,3276,1622,.66602921,.6688444,1945,1342,0,0
2009,50,Vermont,White,3126,2762,5114,4516,3408,1706,2997,1519,.66640592,.66364038,,,0,0
2009,51,Virginia,Asian,7495,7013,15559,14612,10034,5525,9410,5202,.64490008,.64399123,,,0,0
2009,51,Virginia,Black,6510,6249,9971,9503,3293,6678,3044,6459,.33025774,.32031989,,,0,0
2009,51,Virginia,Hispanic,3713,3470,6294,5839,3394,2900,3103,2736,.5392437,.53142661,,,0,0
2009,51,Virginia,Total,63563,57996,115066,104333,69742,45324,62392,41941,.60610431,.59800828,29537,18566,0,0
2009,51,Virginia,White,40485,36333,73477,65456,47313,26164,41709,23747,.64391577,.63720667,,,0,0
2009,53,Washington,Asian,5303,4896,9951,9235,5857,4094,5345,3890,.58858407,.57877642,,,0,0
2009,53,Washington,Black,808,737,1224,1116,401,823,346,770,.32761437,.31003585,,,0,0
2009,53,Washington,Hispanic,2072,1968,3166,3022,1286,1880,1183,1839,.40619078,.39146259,,,0,0
2009,53,Washington,Total,33277,30318,55501,50711,33462,22039,29877,20834,.60290807,.58916211,17235,10336,0,0
2009,53,Washington,White,22459,20315,36724,33295,23381,13343,20757,12538,.63666815,.62342691,,,0,0
2009,54,West Virginia,Asian,194,165,417,343,263,154,214,129,.63069546,.62390673,,,1,0
2009,54,West Virginia,Black,102,98,144,140,27,117,26,114,.1875,.18571429,,,1,0
2009,54,West Virginia,Hispanic,72,67,121,111,43,78,35,76,.35537189,.31531531,,,1,0
2009,54,West Virginia,Total,5396,5117,8637,8078,3753,4884,3383,4695,.43452588,.41879177,3090,1360,1,0
2009,54,West Virginia,White,4808,4577,7600,7147,3232,4368,2934,4213,.42526317,.41052189,,,1,0
2009,55,Wisconsin,Asian,1244,1081,2360,2048,1577,783,1364,684,.66822034,.66601563,,,0,0
2009,55,Wisconsin,Black,651,569,950,834,297,653,258,576,.31263158,.30935252,,,0,0
2009,55,Wisconsin,Hispanic,760,664,1169,1036,659,510,569,467,.5637297,.54922777,,,0,0
2009,55,Wisconsin,Total,27269,24781,43830,39806,30000,13830,27045,12761,.68446273,.67942017,16095,11040,0,0
2009,55,Wisconsin,White,23673,21630,37796,34509,26434,11362,23947,10562,.69938618,.69393492,,,0,0
2009,56,Wyoming,Asian,31,31,57,57,42,15,42,15,.7368421,.7368421,,,0,0
2009,56,Wyoming,Black,5,5,5,5,2,3,2,3,.40000001,.40000001,,,0,0
2009,56,Wyoming,Hispanic,55,55,72,72,36,36,36,36,.5,.5,,,0,0
2009,56,Wyoming,Total,1162,1160,1693,1690,868,825,866,824,.51269937,.51242602,803,426,0,0
2009,56,Wyoming,White,1016,1014,1467,1464,744,723,742,722,.50715744,.50683057,,,0,0
2010,1,Alabama,Asian,718,623,1780,1574,1195,585,1032,542,.67134833,.65565437,,,0,0
2010,1,Alabama,Black,2500,2422,4003,3885,791,3212,731,3154,.1976018,.18815958,,,0,0
2010,1,Alabama,Hispanic,343,295,608,516,273,335,213,303,.44901314,.41279069,,,0,0
2010,1,Alabama,Total,15008,12962,26598,23145,12655,13943,10339,12806,.47578764,.44670555,7710,3573,0,0
2010,1,Alabama,White,10690,8966,18857,16001,9771,9086,7868,8133,.51816303,.49171928,,,0,0
2010,2,Alaska,Asian,303,298,552,541,294,258,284,257,.53260869,.52495378,,,0,0
2010,2,Alaska,Black,56,55,86,85,39,47,38,47,.45348838,.44705883,,,0,0
2010,2,Alaska,Hispanic,95,95,142,142,73,69,73,69,.51408452,.51408452,,,0,0
2010,2,Alaska,Total,2668,2586,4524,4405,2916,1608,2826,1579,.64456236,.64154369,1683,1080,0,0
2010,2,Alaska,White,1897,1833,3231,3144,2221,1010,2156,988,.68740326,.68575066,,,0,0
2010,4,Arizona,Asian,2111,1915,4340,3988,2895,1445,2668,1320,.66705072,.669007,,,0,0
2010,4,Arizona,Black,755,699,1238,1158,481,757,440,718,.3885299,.37996545,,,0,0
2010,4,Arizona,Hispanic,6095,5705,9207,8597,3664,5543,3286,5311,.39795807,.38222635,,,0,0
2010,4,Arizona,Total,23590,21197,39279,35107,21852,17427,19117,15990,.55632782,.54453528,12335,6963,0,0
2010,4,Arizona,White,12780,11220,21501,18735,13440,8061,11563,7172,.6250872,.61718708,,,0,0
2010,5,Arkansas,Asian,696,640,1483,1387,623,860,578,809,.4200944,.41672674,,,1,1
2010,5,Arkansas,Black,2876,2854,4576,4542,410,4166,391,4151,.089597903,.086085424,,,1,1
2010,5,Arkansas,Hispanic,1226,1211,1986,1961,577,1409,559,1402,.29053372,.28505865,,,1,1
2010,5,Arkansas,Total,20639,20020,34561,33593,10333,24228,9784,23809,.29897863,.29125115,10635,3623,1,1
2010,5,Arkansas,White,14636,14144,24335,23575,8043,16292,7602,15973,.3305116,.32246023,,,1,1
2010,6,California,Asian,70111,63162,144683,130467,94324,50359,84198,46269,.65193564,.64535862,,,0,0
2010,6,California,Black,9067,7952,14728,12883,5474,9254,4546,8337,.37167302,.35286811,,,0,0
2010,6,California,Hispanic,81621,76021,134495,125214,59376,75119,53581,71633,.44147366,.42791539,,,0,0
2010,6,California,Total,280770,246257,514150,449736,307089,207061,261580,188156,.59727514,.58163011,131123,85890,0,0
2010,6,California,White,89699,73380,163311,132803,113846,49465,91247,41556,.69711167,.68708539,,,0,0
2010,8,Colorado,Asian,1999,1865,3731,3486,2250,1481,2080,1406,.60305548,.59667242,,,0,0
2010,8,Colorado,Black,1075,1025,1580,1496,524,1056,470,1026,.33164558,.31417114,,,0,0
2010,8,Colorado,Hispanic,3975,3819,5801,5562,2288,3513,2141,3421,.39441475,.38493347,,,0,0
2010,8,Colorado,Total,32693,30464,54326,50510,32371,21955,29720,20790,.59586573,.58839834,16740,10330,0,0
2010,8,Colorado,White,23562,21812,39710,36704,25339,14371,23220,13484,.63810122,.63262862,,,0,0
2010,9,Connecticut,Asian,2231,1503,4896,3201,3788,1108,2368,833,.77369279,.7397688,,,0,0
2010,9,Connecticut,Black,1262,1041,1919,1555,669,1250,449,1106,.34861907,.28874597,,,0,0
2010,9,Connecticut,Hispanic,1660,1417,2675,2242,1499,1176,1176,1066,.56037384,.52453166,,,0,0
2010,9,Connecticut,Total,25646,20098,46184,35271,33408,12776,24911,10360,.72336739,.70627427,11952,8629,0,0
2010,9,Connecticut,White,18720,14787,33435,25844,25120,8315,19244,6600,.7513085,.74462157,,,0,0
2010,10,Delaware,Asian,486,404,1107,944,748,359,618,326,.67570007,.654661,,,0,0
2010,10,Delaware,Black,482,425,717,647,226,491,183,464,.31520224,.28284389,,,0,0
2010,10,Delaware,Hispanic,218,179,373,315,174,199,135,180,.46648794,.42857143,,,0,0
2010,10,Delaware,Total,5019,3582,8834,6374,5156,3678,3262,3112,.58365405,.51176655,2149,1180,0,0
2010,10,Delaware,White,3513,2359,6052,4084,3656,2396,2146,1938,.60409784,.52546525,,,0,0
2010,11,District Of Columbia,Asian,183,83,400,170,260,140,63,107,.64999998,.37058824,,,0,0
2010,11,District Of Columbia,Black,1662,1414,2379,1978,442,1937,220,1758,.18579236,.11122346,,,0,0
2010,11,District Of Columbia,Hispanic,523,381,887,605,307,580,79,526,.34611049,.13057852,,,0,0
2010,11,District Of Columbia,Total,4367,2329,7709,3745,4123,3586,882,2863,.53482944,.23551401,1037,285,0,0
2010,11,District Of Columbia,White,1544,254,3195,636,2601,594,413,223,.81408453,.64937109,,,0,0
2010,12,Florida,Asian,10027,9178,21300,19468,10626,10674,9429,10039,.49887323,.48433328,,,0,1
2010,12,Florida,Black,21759,21154,34341,33313,6521,27820,6030,27283,.18988964,.18101041,,,0,1
2010,12,Florida,Hispanic,41004,36796,71595,63902,30863,40732,25859,38043,.4310776,.40466651,,,0,1
2010,12,Florida,Total,171724,155622,306898,276723,133595,173303,114064,162659,.4353075,.41219559,65741,33712,0,1
2010,12,Florida,White,84123,74939,152725,135338,74967,77758,63519,71819,.49086267,.46933603,,,0,1
2010,13,Georgia,Asian,6776,6327,14016,13073,8897,5119,8232,4841,.63477457,.62969482,,,0,0
2010,13,Georgia,Black,14619,14129,20996,20207,5244,15752,4849,15358,.24976186,.23996635,,,0,0
2010,13,Georgia,Hispanic,4424,4156,7057,6582,3400,3657,3062,3520,.48179114,.46520814,,,0,0
2010,13,Georgia,Total,71808,64256,118367,105046,62313,56054,52957,52089,.52643895,.5041315,30643,15668,0,0
2010,13,Georgia,White,40860,35017,67327,57200,40203,27124,32981,24219,.59713042,.5765909,,,0,0
2010,15,Hawaii,Asian,3951,2298,6197,3272,3531,2666,1346,1926,.56979185,.4113692,,,0,0
2010,15,Hawaii,Black,78,63,108,84,37,71,21,63,.3425926,.25,,,0,0
2010,15,Hawaii,Hispanic,149,104,231,159,109,122,54,105,.47186148,.33962265,,,0,0
2010,15,Hawaii,Total,5941,3442,9329,4931,5373,3956,2088,2843,.57594597,.42344353,2095,1001,0,0
2010,15,Hawaii,White,979,564,1601,856,1006,595,457,399,.62835729,.53387851,,,0,0
2010,16,Idaho,Asian,171,160,357,336,252,105,238,98,.70588237,.70833331,,,0,0
2010,16,Idaho,Black,32,31,47,46,24,23,24,22,.5106383,.52173913,,,0,0
2010,16,Idaho,Hispanic,238,231,380,368,205,175,196,172,.53947371,.53260869,,,0,0
2010,16,Idaho,Total,4812,4653,8120,7876,5593,2527,5413,2463,.68879312,.68727779,2816,1893,0,0
2010,16,Idaho,White,4088,3965,6833,6645,4767,2066,4629,2016,.69764382,.69661397,,,0,0
2010,17,Illinois,Asian,7758,7158,16461,15319,12208,4253,11426,3893,.74163175,.74587113,,,0,0
2010,17,Illinois,Black,6775,6227,9962,9157,2327,7635,2038,7119,.23358764,.22256197,,,0,0
2010,17,Illinois,Hispanic,10006,9021,15289,13878,6829,8460,6093,7785,.446661,.43904021,,,0,0
2010,17,Illinois,Total,71704,62963,126149,111077,83560,42589,73436,37641,.6623913,.66112697,35133,23028,0,0
2010,17,Illinois,White,42287,36221,75535,64802,56523,19012,48857,15945,.7483021,.75394279,,,0,0
2010,18,Indiana,Asian,1607,1355,3252,2773,2106,1146,1774,999,.64760149,.63974035,,,1,1
2010,18,Indiana,Black,1795,1606,2666,2404,467,2199,383,2021,.1751688,.15931781,,,1,1
2010,18,Indiana,Hispanic,1384,1276,2121,1914,762,1359,625,1289,.35926449,.32654127,,,1,1
2010,18,Indiana,Total,35036,31216,54382,48004,23282,31100,19555,28449,.4281196,.40736189,18425,7807,1,1
2010,18,Indiana,White,28600,25502,43653,38541,18862,24791,15882,22659,.43208942,.41208065,,,1,1
2010,19,Iowa,Asian,507,477,1035,990,755,280,729,261,.72946858,.73636365,,,0,0
2010,19,Iowa,Black,136,134,222,220,97,125,96,124,.43693694,.43636364,,,0,0
2010,19,Iowa,Hispanic,262,251,382,363,222,160,207,156,.58115184,.57024795,,,0,0
2010,19,Iowa,Total,8979,8296,14028,13038,9043,4985,8439,4599,.64463931,.64726186,5135,3145,0,0
2010,19,Iowa,White,7667,7062,11713,10850,7529,4184,7017,3833,.64279008,.6467281,,,0,0
2010,20,Kansas,Asian,625,590,1125,1073,735,390,702,371,.65333331,.65424043,,,0,0
2010,20,Kansas,Black,301,291,409,391,146,263,135,256,.35696822,.34526855,,,0,0
2010,20,Kansas,Hispanic,554,532,753,720,346,407,324,396,.45949537,.44999999,,,0,0
2010,20,Kansas,Total,8209,7616,12566,11781,7994,4572,7487,4294,.63616109,.6355148,4705,2805,0,0
2010,20,Kansas,White,6166,5675,9335,8696,6188,3147,5776,2920,.66288161,.66421342,,,0,0
2010,21,Kentucky,Asian,795,720,1602,1448,1046,556,937,511,.65293384,.64709944,,,0,1
2010,21,Kentucky,Black,1052,1011,1571,1501,443,1128,405,1096,.281986,.26982012,,,0,1
2010,21,Kentucky,Hispanic,504,448,823,715,393,430,326,389,.47752127,.45594406,,,0,1
2010,21,Kentucky,Total,22202,19561,36463,31681,17956,18507,14802,16879,.4924444,.4672201,9779,4903,0,1
2010,21,Kentucky,White,18791,16456,30664,26454,15241,15423,12446,14008,.49703234,.47047704,,,0,1
2010,22,Louisiana,Asian,561,446,972,762,590,382,456,306,.60699588,.59842521,,,0,0
2010,22,Louisiana,Black,1307,1131,1707,1462,378,1329,281,1181,.22144112,.19220246,,,0,0
2010,22,Louisiana,Hispanic,324,211,479,287,267,212,143,144,.55741125,.49825785,,,0,0
2010,22,Louisiana,Total,7820,5140,11716,7372,5988,5728,3220,4152,.51109594,.43678784,3198,1307,0,0
2010,22,Louisiana,White,5160,3008,7848,4370,4409,3439,2142,2228,.56179917,.4901602,,,0,0
2010,23,Maine,Asian,436,358,821,690,471,350,395,295,.57369059,.57246375,,,0,0
2010,23,Maine,Black,90,86,140,135,58,82,57,78,.41428572,.42222223,,,0,0
2010,23,Maine,Hispanic,105,96,161,141,89,72,77,64,.55279505,.54609931,,,0,0
2010,23,Maine,Total,7863,7238,12724,11664,7512,5212,6811,4853,.59038037,.58393347,4034,2430,0,0
2010,23,Maine,White,6873,6379,11022,10184,6571,4451,5994,4190,.59617132,.5885703,,,0,0
2010,24,Maryland,Asian,6604,6111,14780,13784,10582,4198,9879,3905,.71596754,.71670049,,,0,0
2010,24,Maryland,Black,9728,8974,15259,14122,4457,10802,3942,10180,.29208991,.27913892,,,0,0
2010,24,Maryland,Hispanic,3634,3351,6184,5683,3317,2867,2961,2722,.53638422,.52102762,,,0,0
2010,24,Maryland,Total,56460,49246,103977,91145,63300,40677,54300,36845,.60878849,.59575403,24961,15167,0,0
2010,24,Maryland,White,32224,27050,59864,50617,40520,19344,33774,16843,.67686754,.66724616,,,0,0
2010,25,Massachusetts,Asian,4606,3338,9671,7003,7242,2429,5054,1949,.74883676,.72169071,,,0,0
2010,25,Massachusetts,Black,1769,1451,2753,2266,952,1801,681,1585,.34580457,.30052957,,,0,0
2010,25,Massachusetts,Hispanic,2451,2092,3888,3294,1821,2067,1406,1888,.46836421,.42683667,,,0,0
2010,25,Massachusetts,Total,41675,32628,73001,56150,51492,21509,38205,17945,.70536017,.68040961,20352,14122,0,0
2010,25,Massachusetts,White,29877,23497,51396,39610,37904,13492,28510,11100,.73748928,.71976775,,,0,0
2010,26,Michigan,Asian,3555,3064,7425,6414,5718,1707,4915,1499,.77010101,.76629251,,,0,0
2010,26,Michigan,Black,2053,1814,2807,2481,935,1872,787,1694,.33309582,.31721079,,,0,0
2010,26,Michigan,Hispanic,1301,1171,1987,1781,1060,927,931,850,.53346753,.52274001,,,0,0
2010,26,Michigan,Total,45554,40125,72880,64053,47822,25058,41558,22495,.65617454,.64880645,24658,15914,0,0
2010,26,Michigan,White,35564,31373,55647,49009,37070,18577,32321,16688,.6661635,.65949112,,,0,0
2010,27,Minnesota,Asian,2446,2077,4591,3914,2788,1803,2382,1532,.60727513,.60858458,,,0,0
2010,27,Minnesota,Black,920,833,1338,1208,510,828,436,772,.38116592,.36092716,,,0,0
2010,27,Minnesota,Hispanic,658,555,1026,844,520,506,407,437,.50682259,.48222747,,,0,0
2010,27,Minnesota,Total,32541,28740,53239,46688,34145,19094,29783,16905,.64135313,.63791555,15354,9797,0,0
2010,27,Minnesota,White,26785,23741,43386,38194,28605,14781,25093,13101,.65931404,.65698802,,,0,0
2010,28,Mississippi,Asian,237,197,465,361,222,243,142,219,.47741935,.39335179,,,0,0
2010,28,Mississippi,Black,1750,1682,2427,2335,270,2157,240,2095,.11124846,.10278372,,,0,0
2010,28,Mississippi,Hispanic,107,95,151,133,50,101,41,92,.33112583,.30827066,,,0,0
2010,28,Mississippi,Total,6312,5411,9258,7751,3189,6069,2299,5452,.34445885,.2966069,3576,1115,0,0
2010,28,Mississippi,White,3875,3144,5685,4481,2472,3213,1753,2728,.43482849,.39120731,,,0,0
2010,29,Missouri,Asian,952,774,2034,1633,1506,528,1196,437,.74041295,.73239434,,,0,0
2010,29,Missouri,Black,1569,1369,2163,1830,390,1773,281,1549,.18030514,.15355191,,,0,0
2010,29,Missouri,Hispanic,539,441,868,669,463,405,321,348,.53341013,.47982064,,,0,0
2010,29,Missouri,Total,17605,13912,28796,21931,18072,10724,12928,9003,.62758714,.58948523,8364,4682,0,0
2010,29,Missouri,White,13589,10586,22080,16586,14771,7309,10493,6093,.66897643,.63264197,,,0,0
2010,30,Montana,Asian,105,101,166,162,121,45,119,43,.72891569,.73456788,,,0,0
2010,30,Montana,Black,8,7,11,10,4,7,3,7,.36363637,.30000001,,,0,0
2010,30,Montana,Hispanic,56,53,88,83,52,36,50,33,.59090906,.60240966,,,0,0
2010,30,Montana,Total,2938,2684,4607,4219,2934,1673,2716,1503,.63685697,.64375442,1802,1174,0,0
2010,30,Montana,White,2593,2367,4071,3717,2617,1454,2413,1304,.64283961,.64917946,,,0,0
2010,31,Nebraska,Asian,276,241,565,484,368,197,306,178,.65132743,.63223141,,,0,0
2010,31,Nebraska,Black,126,115,188,171,67,121,57,114,.35638297,.33333334,,,0,0
2010,31,Nebraska,Hispanic,213,199,326,303,145,181,133,170,.44478527,.43894389,,,0,0
2010,31,Nebraska,Total,4631,4020,7961,6911,4725,3236,4004,2907,.59351838,.57936621,2498,1497,0,0
2010,31,Nebraska,White,3804,3271,6467,5573,3901,2566,3290,2283,.60321635,.59034634,,,0,0
2010,32,Nevada,Asian,1980,1879,3911,3680,1829,2082,1667,2013,.46765533,.45298913,,,0,0
2010,32,Nevada,Black,581,558,934,899,280,654,264,635,.29978585,.29365963,,,0,0
2010,32,Nevada,Hispanic,2394,2312,3895,3736,1364,2531,1260,2476,.35019255,.33725911,,,0,0
2010,32,Nevada,Total,11302,10625,19799,18490,9524,10275,8629,9861,.4810344,.4666847,5949,3148,0,0
2010,32,Nevada,White,5494,5075,9580,8791,5390,4190,4852,3939,.56263047,.5519281,,,0,0
2010,33,New Hampshire,Asian,527,213,1025,404,797,228,301,103,.77756095,.74504948,,,0,0
2010,33,New Hampshire,Black,49,27,69,39,42,27,24,15,.60869563,.61538464,,,0,0
2010,33,New Hampshire,Hispanic,142,97,213,146,161,52,106,40,.75586855,.72602737,,,0,0
2010,33,New Hampshire,Total,5987,4439,9477,6810,6947,2530,4937,1873,.73303789,.72496331,3160,2311,0,0
2010,33,New Hampshire,White,4944,3900,7592,5880,5516,2076,4262,1618,.72655427,.72482991,,,0,0
2010,34,New Jersey,Asian,8919,7933,19209,17160,15171,4038,13678,3482,.78978604,.79708624,,,0,0
2010,34,New Jersey,Black,2495,2035,3836,3140,1639,2197,1289,1851,.427268,.41050956,,,0,0
2010,34,New Jersey,Hispanic,4523,3844,6964,5893,3991,2973,3335,2558,.5730902,.56592566,,,0,0
2010,34,New Jersey,Total,48836,39895,89886,73670,64826,25060,53540,20130,.72120243,.72675443,25016,18214,0,0
2010,34,New Jersey,White,29033,23043,52623,41789,38988,13635,31326,10463,.74089277,.74962312,,,0,0
2010,35,New Mexico,Asian,307,248,597,496,375,222,294,202,.62814069,.59274191,,,0,0
2010,35,New Mexico,Black,139,126,204,186,68,136,58,128,.33333334,.31182796,,,0,0
2010,35,New Mexico,Hispanic,2954,2654,4333,3894,1475,2858,1225,2669,.3404108,.31458655,,,0,0
2010,35,New Mexico,Total,7636,6398,11813,9971,5266,6547,4165,5806,.44578007,.41771138,3980,1820,0,0
2010,35,New Mexico,White,3204,2606,5138,4253,2789,2349,2208,2045,.54281819,.51916295,,,0,0
2010,36,New York,Asian,16363,14899,31447,28740,22201,9246,20360,8380,.70598149,.70842034,,,0,0
2010,36,New York,Black,9618,8287,13976,12125,4707,9269,3864,8261,.33679163,.31868041,,,0,0
2010,36,New York,Hispanic,14489,12255,21492,18255,11030,10462,9215,9040,.51321423,.50479323,,,0,0
2010,36,New York,Total,129031,110212,219953,189399,141027,78926,120484,68915,.64116877,.6361385,60856,39463,0,0
2010,36,New York,White,77687,65489,134287,114107,91940,42347,77636,36471,.68465304,.68037891,,,0,0
2010,37,North Carolina,Asian,3091,2805,7144,6543,4807,2337,4334,2209,.67287236,.66238731,,,0,0
2010,37,North Carolina,Black,5093,4861,8285,7895,2442,5843,2230,5665,.29474956,.28245726,,,0,0
2010,37,North Carolina,Hispanic,2324,2149,4166,3813,2134,2032,1883,1930,.51224196,.49383688,,,0,0
2010,37,North Carolina,Total,49059,43081,92334,80843,54807,37527,46446,34397,.59357333,.57452101,24629,15019,0,0
2010,37,North Carolina,White,35400,30454,66470,57021,41791,24679,34866,22155,.62871975,.61145896,,,0,0
2010,38,North Dakota,Asian,47,41,76,69,49,27,44,25,.64473683,.63768119,,,0,0
2010,38,North Dakota,Black,6,5,8,7,3,5,3,4,.375,.42857143,,,0,0
2010,38,North Dakota,Hispanic,16,16,19,19,13,6,13,6,.68421054,.68421054,,,0,0
2010,38,North Dakota,Total,1198,1083,1645,1485,1016,629,929,556,.61762917,.62558925,721,474,0,0
2010,38,North Dakota,White,1096,989,1497,1347,927,570,847,500,.6192385,.62880474,,,0,0
2010,39,Ohio,Asian,2649,2164,5665,4666,4388,1277,3605,1061,.77458078,.77261037,,,0,0
2010,39,Ohio,Black,2797,2430,4095,3541,1298,2797,1037,2504,.31697193,.29285511,,,0,0
2010,39,Ohio,Hispanic,992,816,1508,1237,881,627,698,539,.58421749,.56426841,,,0,0
2010,39,Ohio,Total,48633,39403,79794,64298,51344,28450,40394,23904,.64345688,.62823105,23045,14323,0,0
2010,39,Ohio,White,39358,31713,63813,51095,41832,21981,32787,18308,.65554041,.64168704,,,0,0
2010,40,Oklahoma,Asian,987,914,2036,1894,1126,910,1016,878,.55304521,.53643084,,,0,0
2010,40,Oklahoma,Black,825,800,1249,1214,313,936,298,916,.25060049,.24546953,,,0,0
2010,40,Oklahoma,Hispanic,971,905,1505,1399,606,899,538,861,.40265781,.38456041,,,0,0
2010,40,Oklahoma,Total,14631,13462,24547,22512,11986,12561,10682,11830,.48828778,.47450247,7853,3895,0,0
2010,40,Oklahoma,White,9654,8775,16162,14638,8385,7777,7421,7217,.51880956,.50696814,,,0,0
2010,41,Oregon,Asian,1744,1506,3143,2772,1976,1167,1701,1071,.62869871,.61363637,,,0,0
2010,41,Oregon,Black,234,214,348,321,131,217,113,208,.37643677,.35202491,,,0,0
2010,41,Oregon,Hispanic,1020,963,1493,1406,624,869,567,839,.41795042,.4032717,,,0,0
2010,41,Oregon,Total,14257,12818,22339,20064,13337,9002,11678,8386,.5970276,.58203751,7584,4580,0,0
2010,41,Oregon,White,10178,9165,15610,14000,9601,6009,8417,5583,.61505443,.60121429,,,0,0
2010,42,Pennsylvania,Asian,4275,3409,8683,7073,6136,2547,5028,2045,.7066682,.71087235,,,0,0
2010,42,Pennsylvania,Black,3166,2692,4450,3785,1009,3441,763,3022,.22674157,.2015852,,,0,0
2010,42,Pennsylvania,Hispanic,1544,1267,2381,1916,1198,1183,913,1003,.50314993,.47651356,,,0,0
2010,42,Pennsylvania,Total,50570,41089,84068,67945,55828,28240,44872,23073,.66408145,.66041648,25561,16488,0,0
2010,42,Pennsylvania,White,38796,31566,63797,51502,44467,19330,35928,15574,.69700772,.697604,,,0,0
2010,44,Rhode Island,Asian,256,150,547,314,383,164,205,109,.7001828,.65286624,,,0,0
2010,44,Rhode Island,Black,104,74,163,107,65,98,35,72,.39877301,.32710281,,,0,0
2010,44,Rhode Island,Hispanic,335,259,461,348,202,259,146,202,.43817788,.41954023,,,0,0
2010,44,Rhode Island,Total,4299,2689,7505,4399,4897,2608,2663,1736,.6524983,.60536486,1795,1095,0,0
2010,44,Rhode Island,White,3306,2043,5790,3352,3923,1867,2133,1219,.67754751,.63633651,,,0,0
2010,45,South Carolina,Asian,842,742,1747,1544,1231,516,1095,449,.70463651,.70919687,,,1,1
2010,45,South Carolina,Black,2627,2565,3786,3678,1089,2697,1037,2641,.28763866,.28194672,,,1,1
2010,45,South Carolina,Hispanic,638,599,1021,947,540,481,492,455,.52889323,.51953536,,,1,1
2010,45,South Carolina,Total,19587,17777,32156,28772,17993,14163,15806,12966,.55955344,.54935354,9626,5409,1,1
2010,45,South Carolina,White,14276,12740,23649,20788,14122,9527,12257,8531,.59714997,.58961904,,,1,1
2010,46,South Dakota,Asian,71,62,136,123,103,33,93,30,.75735295,.75609756,,,0,0
2010,46,South Dakota,Black,32,32,56,56,15,41,15,41,.26785713,.26785713,,,0,0
2010,46,South Dakota,Hispanic,28,23,48,40,26,22,21,19,.54166669,.52499998,,,0,0
2010,46,South Dakota,Total,2337,2149,3900,3617,2486,1414,2280,1337,.63743591,.63035667,1481,885,0,0
2010,46,South Dakota,White,2079,1920,3448,3206,2217,1231,2033,1173,.64298141,.6341235,,,0,0
2010,47,Tennessee,Asian,1271,992,2795,2164,1905,890,1426,738,.68157423,.65896487,,,0,0
2010,47,Tennessee,Black,3069,2839,4296,3963,940,3356,812,3151,.21880819,.20489529,,,0,0
2010,47,Tennessee,Hispanic,691,592,1064,890,532,532,406,484,.5,.45617977,,,0,0
2010,47,Tennessee,Total,21402,16556,35390,26665,20461,14929,14089,12576,.57815766,.5283705,9637,5017,0,0
2010,47,Tennessee,White,15223,11240,25188,18146,15942,9246,10699,7447,.63292044,.58960652,,,0,0
2010,48,Texas,Asian,17248,16320,39674,37869,24968,14706,23644,14225,.62932903,.62436295,,,0,0
2010,48,Texas,Black,13469,13027,22050,21343,5284,16766,4920,16423,.23963718,.23052055,,,0,0
2010,48,Texas,Hispanic,65993,63902,107299,103660,35456,71843,33452,70208,.33044112,.32270885,,,0,0
2010,48,Texas,Total,179320,168351,325571,305544,153539,172032,139590,165954,.47159913,.45685726,82249,42254,0,0
2010,48,Texas,White,72434,65735,136903,124546,79101,57802,69920,54626,.57778865,.56139898,,,0,0
2010,49,Utah,Asian,917,793,1694,1453,1076,618,934,519,.63518298,.64280796,,,0,0
2010,49,Utah,Black,121,109,166,144,88,78,76,68,.53012049,.52777779,,,0,0
2010,49,Utah,Hispanic,996,904,1500,1346,783,717,713,633,.52200001,.52971768,,,0,0
2010,49,Utah,Total,17210,15833,27890,25491,18671,9219,17153,8338,.66945142,.67290413,9614,6503,0,0
2010,49,Utah,White,14258,13198,23137,21307,15889,7248,14679,6628,.68673551,.68892854,,,0,0
2010,50,Vermont,Asian,230,100,420,185,235,185,114,71,.55952382,.61621624,,,0,0
2010,50,Vermont,Black,33,28,44,39,20,24,18,21,.45454547,.46153846,,,0,0
2010,50,Vermont,Hispanic,53,43,79,65,49,30,42,23,.62025315,.64615387,,,0,0
2010,50,Vermont,Total,3677,3151,6057,5166,3744,2313,3232,1934,.61812776,.62562913,2126,1460,0,0
2010,50,Vermont,White,3212,2860,5280,4688,3292,1988,2933,1755,.62348485,.62563992,,,0,0
2010,51,Virginia,Asian,8215,7683,17649,16547,11108,6541,10394,6153,.6293841,.62815011,,,0,0
2010,51,Virginia,Black,7139,6874,10986,10556,3558,7428,3327,7229,.32386672,.31517619,,,0,0
2010,51,Virginia,Hispanic,4161,3929,6968,6528,3826,3142,3507,3021,.5490815,.53722429,,,0,0
2010,51,Virginia,Total,67418,61768,123135,112372,74302,48833,66853,45519,.60341901,.59492576,30781,19162,0,0
2010,51,Virginia,White,42007,37808,76425,68460,49388,27037,43801,24659,.64622831,.63980424,,,0,0
2010,53,Washington,Asian,5714,5262,10674,9958,6333,4341,5824,4134,.59331083,.58485639,,,0,0
2010,53,Washington,Black,955,879,1410,1294,536,874,464,830,.38014185,.35857806,,,0,0
2010,53,Washington,Hispanic,2485,2267,3668,3347,1442,2226,1289,2058,.39312977,.38512102,,,0,0
2010,53,Washington,Total,35646,32332,58897,53638,35436,23461,31670,21968,.60166055,.59043962,18296,11182,0,0
2010,53,Washington,White,23302,21018,37790,34154,24125,13665,21433,12721,.63839638,.62753999,,,0,0
2010,54,West Virginia,Asian,173,142,409,350,282,127,246,104,.68948656,.70285714,,,1,0
2010,54,West Virginia,Black,104,98,164,156,35,129,34,122,.21341464,.21794872,,,1,0
2010,54,West Virginia,Hispanic,65,60,101,89,42,59,32,57,.41584158,.35955057,,,1,0
2010,54,West Virginia,Total,5395,5029,8715,8057,3632,5083,3264,4793,.41675273,.40511358,3204,1328,1,0
2010,54,West Virginia,White,4780,4477,7558,7022,3070,4488,2780,4242,.40619212,.39589861,,,1,0
2010,55,Wisconsin,Asian,1306,1127,2587,2229,1805,782,1546,683,.6977194,.69358456,,,0,0
2010,55,Wisconsin,Black,667,574,945,832,318,627,274,558,.33650795,.32932693,,,0,0
2010,55,Wisconsin,Hispanic,970,858,1419,1251,776,643,667,584,.54686397,.53317344,,,0,0
2010,55,Wisconsin,Total,29382,26687,47552,43226,32740,14812,29639,13587,.6885094,.68567526,16691,11618,0,0
2010,55,Wisconsin,White,25251,23057,40611,37130,28545,12066,26001,11129,.70288837,.70026934,,,0,0
2010,56,Wyoming,Asian,33,32,61,60,40,21,40,20,.6557377,.66666669,,,0,0
2010,56,Wyoming,Black,8,8,10,10,3,7,3,7,.30000001,.30000001,,,0,0
2010,56,Wyoming,Hispanic,63,62,87,85,41,46,40,45,.47126436,.47058824,,,0,0
2010,56,Wyoming,Total,1117,1114,1637,1633,872,765,870,763,.53268176,.53276181,827,450,0,0
2010,56,Wyoming,White,946,945,1369,1368,731,638,730,638,.53396642,.53362572,,,0,0
2011,1,Alabama,Asian,800,687,1735,1514,1094,641,928,586,.63054752,.61294585,,,0,0
2011,1,Alabama,Black,3233,3120,5106,4927,959,4147,877,4050,.18781826,.17799878,,,0,0
2011,1,Alabama,Hispanic,414,357,730,629,333,397,259,370,.45616439,.41176471,,,0,0
2011,1,Alabama,Total,17084,14853,29715,26029,13282,16433,10944,15085,.44697964,.42045411,8584,3872,0,0
2011,1,Alabama,White,11851,10007,20812,17783,10295,10517,8390,9393,.49466655,.4717989,,,0,0
2011,2,Alaska,Asian,291,282,511,498,294,217,286,212,.57534248,.57429719,,,0,0
2011,2,Alaska,Black,63,61,90,86,43,47,41,45,.47777778,.47674417,,,0,0
2011,2,Alaska,Hispanic,113,111,161,159,91,70,90,69,.56521738,.56603771,,,0,0
2011,2,Alaska,Total,2638,2556,4636,4511,2985,1651,2898,1613,.64387405,.64242959,1599,1006,0,0
2011,2,Alaska,White,1864,1803,3385,3295,2298,1087,2232,1063,.67887741,.67738998,,,0,0
2011,4,Arizona,Asian,2392,2184,4996,4599,3390,1606,3125,1474,.67854285,.67949551,,,0,0
2011,4,Arizona,Black,785,734,1254,1164,495,759,444,720,.39473686,.38144329,,,0,0
2011,4,Arizona,Hispanic,6571,6145,10307,9613,4119,6188,3707,5906,.39963132,.38562363,,,0,0
2011,4,Arizona,Total,25284,22682,42982,38478,24258,18724,21266,17212,.56437576,.55267948,13297,7675,0,0
2011,4,Arizona,White,13526,11836,23270,20318,14830,8440,12790,7528,.63730127,.62949109,,,0,0
2011,5,Arkansas,Asian,762,709,1755,1636,763,992,701,935,.43475783,.42848411,,,1,1
2011,5,Arkansas,Black,3106,3067,4958,4907,464,4494,449,4458,.093586124,.091501936,,,1,1
2011,5,Arkansas,Hispanic,1466,1450,2416,2389,640,1776,627,1762,.26490065,.2624529,,,1,1
2011,5,Arkansas,Total,22023,21281,37527,36422,11556,25971,10949,25473,.30793828,.30061501,11326,3827,1,1
2011,5,Arkansas,White,15578,14980,26624,25770,9169,17455,8684,17086,.34438851,.336981,,,1,1
2011,6,California,Asian,75037,67611,157806,141858,104811,52995,93357,48501,.66417629,.65810174,,,0,0
2011,6,California,Black,9579,8420,15566,13678,5959,9607,4970,8708,.38282153,.36335722,,,0,0
2011,6,California,Hispanic,91452,85362,152663,142345,66426,86237,60178,82167,.43511525,.42276159,,,0,0
2011,6,California,Total,299829,263582,550988,482587,329294,221694,280833,201754,.59764278,.58193237,136787,90409,0,0
2011,6,California,White,93583,76843,172405,140952,120990,51415,97328,43624,.70177782,.69050455,,,0,0
2011,8,Colorado,Asian,2196,2051,4062,3793,2616,1446,2405,1388,.6440177,.63406277,,,0,0
2011,8,Colorado,Black,1140,1082,1673,1580,552,1121,495,1085,.32994619,.31329113,,,0,0
2011,8,Colorado,Hispanic,4450,4287,6545,6264,2599,3946,2412,3852,.39709702,.38505748,,,0,0
2011,8,Colorado,Total,35127,32772,57937,53768,34823,23114,31720,22048,.60104942,.58994198,17303,10692,0,0
2011,8,Colorado,White,24887,23053,41882,38609,27059,14823,24598,14011,.6460771,.63710535,,,0,0
2011,9,Connecticut,Asian,2502,1627,5386,3364,4209,1177,2567,797,.78147048,.76307964,,,0,0
2011,9,Connecticut,Black,1391,1145,2256,1849,834,1422,586,1263,.36968085,.31692806,,,0,0
2011,9,Connecticut,Hispanic,1992,1697,3272,2754,1808,1464,1425,1329,.55256724,.51742917,,,0,0
2011,9,Connecticut,Total,27280,21434,49608,37896,35779,13829,26725,11171,.7212345,.70521957,12906,9270,0,0
2011,9,Connecticut,White,19685,15662,35658,27675,26863,8795,20693,6982,.75335127,.74771452,,,0,0
2011,10,Delaware,Asian,500,403,1112,907,741,371,568,339,.66636693,.62624037,,,0,0
2011,10,Delaware,Black,536,458,842,725,277,565,197,528,.32897863,.27172413,,,0,0
2011,10,Delaware,Hispanic,263,223,457,386,184,273,131,255,.40262583,.33937824,,,0,0
2011,10,Delaware,Total,5287,3718,9303,6591,5194,4109,3161,3430,.5583145,.4795934,2191,1172,0,0
2011,10,Delaware,White,3667,2387,6335,4154,3706,2629,2083,2071,.58500397,.5014444,,,0,0
2011,11,District Of Columbia,Asian,195,81,397,141,278,119,57,84,.70025188,.40425533,,,1,1
2011,11,District Of Columbia,Black,1784,1512,2430,1974,524,1906,263,1711,.21563786,.13323201,,,1,1
2011,11,District Of Columbia,Hispanic,569,458,933,732,289,644,127,605,.30975348,.17349727,,,1,1
2011,11,District Of Columbia,Total,4594,2553,7929,3904,4327,3602,1013,2891,.54571825,.25947747,1471,323,1,1
2011,11,District Of Columbia,White,1616,296,3428,734,2786,642,459,275,.81271881,.62534058,,,1,1
2011,12,Florida,Asian,11000,9912,23794,21474,12715,11079,11126,10348,.53437841,.51811492,,,0,1
2011,12,Florida,Black,22969,22129,36891,35481,7680,29211,7110,28371,.20818086,.20038894,,,0,1
2011,12,Florida,Hispanic,44358,39267,77822,68513,34120,43702,28386,40127,.43843642,.41431552,,,0,1
2011,12,Florida,Total,181934,163172,326341,290678,146719,179622,124362,166316,.449588,.42783424,72767,36707,0,1
2011,12,Florida,White,88739,78630,163163,143566,82165,80998,69584,73982,.50357616,.48468301,,,0,1
2011,13,Georgia,Asian,7119,6601,14993,13875,9792,5201,8968,4907,.65310478,.64634234,,,0,0
2011,13,Georgia,Black,15407,14846,22412,21551,5717,16695,5291,16260,.25508657,.24551065,,,0,0
2011,13,Georgia,Hispanic,4795,4483,7899,7370,3675,4224,3321,4049,.46524876,.45061058,,,0,0
2011,13,Georgia,Total,72384,64205,120706,106109,65818,54888,55376,50733,.54527527,.52187842,31764,16476,0,0
2011,13,Georgia,White,40462,34097,68297,56945,43134,25163,34824,22121,.63156509,.61153746,,,0,0
2011,15,Hawaii,Asian,4277,2627,6780,3825,3790,2990,1506,2319,.55899704,.39372548,,,0,0
2011,15,Hawaii,Black,93,77,134,107,50,84,32,75,.37313432,.29906541,,,0,0
2011,15,Hawaii,Hispanic,190,123,295,178,150,145,75,103,.50847459,.4213483,,,0,0
2011,15,Hawaii,Total,6517,3991,10249,5808,5770,4479,2386,3422,.56298172,.41081268,2338,1060,0,0
2011,15,Hawaii,White,1088,633,1757,982,1102,655,512,470,.62720549,.52138495,,,0,0
2011,16,Idaho,Asian,219,208,482,460,339,143,328,132,.70331949,.71304345,,,0,0
2011,16,Idaho,Black,38,37,61,60,32,29,31,29,.52459013,.51666665,,,0,0
2011,16,Idaho,Hispanic,252,247,417,411,216,201,213,198,.51798558,.5182482,,,0,0
2011,16,Idaho,Total,4998,4833,8584,8341,5843,2741,5682,2659,.68068498,.68121326,3016,2079,0,0
2011,16,Idaho,White,4265,4122,7263,7055,5052,2211,4910,2145,.69558036,.69596028,,,0,0
2011,17,Illinois,Asian,8844,8052,18728,17201,13861,4867,12782,4419,.74012172,.74309635,,,0,0
2011,17,Illinois,Black,7884,7103,11787,10645,2717,9070,2315,8330,.23050819,.21747299,,,0,0
2011,17,Illinois,Hispanic,11763,10598,18420,16700,7884,10536,7033,9667,.42801303,.42113772,,,0,0
2011,17,Illinois,Total,78654,68874,138091,121447,90168,47923,78958,42489,.65296072,.65014368,37723,24449,0,0
2011,17,Illinois,White,45358,38898,81234,69914,60880,20354,52593,17321,.7494399,.75225276,,,0,0
2011,18,Indiana,Asian,1746,1481,3598,3082,2357,1241,1992,1090,.65508616,.64633358,,,1,1
2011,18,Indiana,Black,2038,1875,2991,2739,598,2393,505,2234,.19993313,.18437386,,,1,1
2011,18,Indiana,Hispanic,1673,1553,2606,2401,929,1677,794,1607,.35648504,.33069554,,,1,1
2011,18,Indiana,Total,38418,34529,60512,53881,27188,33324,22967,30914,.44929931,.42625415,20047,8772,1,1
2011,18,Indiana,White,31281,28095,48764,43369,22259,26505,18803,24566,.45646378,.43355852,,,1,1
2011,19,Iowa,Asian,548,509,1103,1022,807,296,752,270,.73164099,.73581213,,,0,0
2011,19,Iowa,Black,173,167,261,253,115,146,110,143,.44061303,.43478259,,,0,0
2011,19,Iowa,Hispanic,311,291,448,413,239,209,222,191,.53348213,.53753024,,,0,0
2011,19,Iowa,Total,9609,8816,14896,13629,9740,5156,8948,4681,.65386683,.65654123,5345,3392,0,0
2011,19,Iowa,White,8107,7420,12401,11329,8168,4233,7492,3837,.65865654,.66131169,,,0,0
2011,20,Kansas,Asian,723,684,1370,1319,865,505,835,484,.63138688,.63305533,,,0,0
2011,20,Kansas,Black,345,335,488,473,164,324,155,318,.33606556,.32769555,,,0,0
2011,20,Kansas,Hispanic,736,708,1071,1031,386,685,361,670,.36041084,.35014549,,,0,0
2011,20,Kansas,Total,9201,8555,14277,13363,8690,5587,8117,5246,.60867131,.60742348,4853,2943,0,0
2011,20,Kansas,White,6844,6312,10561,9806,6854,3707,6374,3432,.64899158,.65001017,,,0,0
2011,21,Kentucky,Asian,930,832,1872,1666,1244,628,1104,562,.66452992,.66266507,,,0,1
2011,21,Kentucky,Black,1338,1295,1979,1914,568,1411,541,1373,.28701365,.28265414,,,0,1
2011,21,Kentucky,Hispanic,633,576,1098,978,529,569,448,530,.48178506,.4580777,,,0,1
2011,21,Kentucky,Total,26226,23507,42768,37923,20638,22130,17368,20555,.48255706,.45798063,10872,5393,0,1
2011,21,Kentucky,White,22168,19757,36052,31806,17504,18548,14627,17179,.48552093,.45988178,,,0,1
2011,22,Louisiana,Asian,576,459,1070,850,698,372,543,307,.65233648,.63882351,,,0,0
2011,22,Louisiana,Black,1408,1244,1915,1679,406,1509,320,1359,.21201044,.19058964,,,0,0
2011,22,Louisiana,Hispanic,343,229,531,336,270,261,142,194,.50847459,.42261904,,,0,0
2011,22,Louisiana,Total,8474,5623,12680,8084,6379,6301,3436,4648,.50307572,.42503712,3528,1474,0,0
2011,22,Louisiana,White,5679,3362,8496,4753,4712,3784,2261,2492,.55461395,.47569954,,,0,0
2011,23,Maine,Asian,522,426,936,770,544,392,439,331,.58119661,.57012987,,,0,0
2011,23,Maine,Black,85,78,128,115,51,77,46,69,.3984375,.40000001,,,0,0
2011,23,Maine,Hispanic,112,98,194,170,106,88,97,73,.54639173,.57058823,,,0,0
2011,23,Maine,Total,7961,7324,12781,11658,7627,5154,6922,4736,.59674519,.59375536,4400,2755,0,0
2011,23,Maine,White,6906,6425,10984,10124,6627,4357,6076,4048,.6033321,.60015804,,,0,0
2011,24,Maryland,Asian,7056,6504,15829,14694,11310,4519,10542,4152,.71451133,.71743572,,,0,0
2011,24,Maryland,Black,10499,9688,16798,15572,4861,11937,4380,11192,.28937969,.28127408,,,0,0
2011,24,Maryland,Hispanic,4034,3721,7004,6441,3610,3394,3207,3234,.51541978,.49790406,,,0,0
2011,24,Maryland,Total,59617,52153,110641,97182,66628,44013,57362,39820,.60219991,.59025335,25934,15586,0,0
2011,24,Maryland,White,33666,28392,63498,53863,42720,20778,35659,18204,.67277712,.66203147,,,0,0
2011,25,Massachusetts,Asian,5241,3780,10916,7728,8269,2647,5713,2015,.75751191,.73925984,,,0,0
2011,25,Massachusetts,Black,2034,1706,3183,2671,1105,2078,823,1848,.34715676,.3081243,,,0,0
2011,25,Massachusetts,Hispanic,2675,2256,4335,3600,2090,2245,1562,2038,.48212227,.43388888,,,0,0
2011,25,Massachusetts,Total,44912,35482,79130,61286,55957,23173,41948,19338,.70715278,.68446302,21605,15129,0,0
2011,25,Massachusetts,White,31937,25450,55644,43553,41121,14523,31501,12052,.73900151,.72327965,,,0,0
2011,26,Michigan,Asian,3686,3170,7844,6794,6078,1766,5258,1536,.77485979,.77391815,,,0,0
2011,26,Michigan,Black,2451,2131,3407,2980,1017,2390,847,2133,.29850307,.28422818,,,0,0
2011,26,Michigan,Hispanic,1380,1242,2078,1855,1111,967,964,891,.53464872,.51967657,,,0,0
2011,26,Michigan,Total,48745,42963,78679,69278,50979,27700,44506,24772,.64793652,.64242619,25709,16628,0,0
2011,26,Michigan,White,38095,33673,60530,53420,39908,20622,34951,18469,.65930945,.65426809,,,0,0
2011,27,Minnesota,Asian,2581,2185,4915,4111,3171,1744,2640,1471,.64516783,.64217949,,,0,0
2011,27,Minnesota,Black,1061,958,1593,1416,599,994,511,905,.37602007,.3608757,,,0,0
2011,27,Minnesota,Hispanic,810,675,1237,1013,638,599,497,516,.51576394,.49062192,,,0,0
2011,27,Minnesota,Total,35091,30988,56942,49877,37000,19942,32156,17721,.64978397,.64470595,16181,10493,0,0
2011,27,Minnesota,White,28755,25473,46266,40718,30900,15366,27024,13694,.66787708,.66368681,,,0,0
2011,28,Mississippi,Asian,291,246,509,409,251,258,172,237,.49312377,.42053789,,,0,0
2011,28,Mississippi,Black,1657,1549,2242,2090,236,2006,202,1888,.10526316,.09665072,,,0,0
2011,28,Mississippi,Hispanic,156,139,231,204,62,169,48,156,.26839826,.23529412,,,0,0
2011,28,Mississippi,Total,6350,5370,9329,7722,3247,6082,2392,5330,.34805447,.3097643,3605,1133,0,0
2011,28,Mississippi,White,3940,3165,5923,4653,2556,3367,1852,2801,.43153808,.39802277,,,0,0
2011,29,Missouri,Asian,1134,915,2357,1900,1725,632,1385,515,.73186255,.72894734,,,0,0
2011,29,Missouri,Black,1597,1390,2216,1898,440,1776,327,1571,.19855596,.17228661,,,0,0
2011,29,Missouri,Hispanic,519,421,810,629,433,377,305,324,.53456789,.48489666,,,0,0
2011,29,Missouri,Total,18057,14265,29352,22439,19034,10318,13948,8491,.64847368,.62159634,8560,4959,0,0
2011,29,Missouri,White,13867,10793,22493,16922,15587,6906,11364,5558,.69297117,.67155182,,,0,0
2011,30,Montana,Asian,72,66,124,116,80,44,75,41,.64516127,.64655173,,,0,0
2011,30,Montana,Black,11,10,13,12,7,6,6,6,.53846157,.5,,,0,0
2011,30,Montana,Hispanic,60,51,95,82,60,35,53,29,.63157892,.64634144,,,0,0
2011,30,Montana,Total,3023,2798,4683,4296,3036,1647,2792,1504,.64830238,.64990687,1823,1196,0,0
2011,30,Montana,White,2694,2498,4195,3845,2765,1430,2536,1309,.659118,.65955788,,,0,0
2011,31,Nebraska,Asian,316,270,656,562,408,248,346,216,.62195122,.61565834,,,0,0
2011,31,Nebraska,Black,151,141,238,224,86,152,75,149,.36134455,.33482143,,,0,0
2011,31,Nebraska,Hispanic,285,266,438,406,181,257,157,249,.41324201,.3866995,,,0,0
2011,31,Nebraska,Total,5151,4546,8738,7737,5064,3674,4395,3342,.57953763,.56804961,2665,1605,0,0
2011,31,Nebraska,White,4146,3642,6989,6172,4186,2803,3639,2533,.59894121,.58959818,,,0,0
2011,32,Nevada,Asian,2100,1985,3967,3716,1887,2080,1717,1999,.4756743,.46205598,,,0,0
2011,32,Nevada,Black,561,536,919,876,260,659,245,631,.28291622,.27968037,,,0,0
2011,32,Nevada,Hispanic,2608,2525,4297,4132,1461,2836,1359,2773,.34000465,.3288964,,,0,0
2011,32,Nevada,Total,11996,11230,20908,19460,9988,10920,9064,10396,.47771189,.46577594,6217,3451,0,0
2011,32,Nevada,White,5845,5370,10271,9393,5774,4497,5198,4195,.56216532,.5533908,,,0,0
2011,33,New Hampshire,Asian,564,251,1118,444,893,225,360,84,.79874778,.8108108,,,0,0
2011,33,New Hampshire,Black,45,25,70,35,39,31,24,11,.55714285,.6857143,,,0,0
2011,33,New Hampshire,Hispanic,157,108,252,172,183,69,124,48,.72619045,.72093022,,,0,0
2011,33,New Hampshire,Total,6123,4581,10061,7247,7356,2705,5302,1945,.73114002,.7316131,3206,2454,0,0
2011,33,New Hampshire,White,5039,4009,8104,6302,5858,2246,4583,1719,.72285289,.72722948,,,0,0
2011,34,New Jersey,Asian,9877,8731,21710,19293,17168,4542,15378,3915,.79078764,.79707664,,,0,0
2011,34,New Jersey,Black,2676,2184,4177,3375,1831,2346,1450,1925,.43835288,.42962962,,,0,0
2011,34,New Jersey,Hispanic,4840,4089,7797,6574,4331,3466,3609,2965,.55547005,.54898083,,,0,0
2011,34,New Jersey,Total,51469,42295,95590,78591,69487,26103,57429,21162,.72692752,.7307325,26546,19486,0,0
2011,34,New Jersey,White,30239,24219,55275,44133,41547,13728,33404,10729,.75164181,.75689393,,,0,0
2011,35,New Mexico,Asian,335,257,672,530,424,248,315,215,.63095236,.59433961,,,0,0
2011,35,New Mexico,Black,146,129,217,196,48,169,39,157,.22119816,.19897959,,,0,0
2011,35,New Mexico,Hispanic,3702,3330,5447,4917,1739,3708,1462,3455,.3192583,.29733577,,,0,0
2011,35,New Mexico,Total,8902,7435,13941,11792,5953,7988,4681,7111,.42701384,.39696404,4274,1954,0,0
2011,35,New Mexico,White,3540,2832,5885,4820,3220,2665,2524,2296,.54715377,.52365148,,,0,0
2011,36,New York,Asian,18054,16408,34928,31929,24595,10333,22589,9340,.70416284,.70747596,,,0,0
2011,36,New York,Black,10112,8519,15044,12777,5304,9740,4397,8380,.3525658,.344134,,,0,0
2011,36,New York,Hispanic,15565,13046,23172,19522,11665,11507,9760,9762,.50340927,.49994877,,,0,0
2011,36,New York,Total,133871,113851,228147,195922,146830,81317,126113,69809,.64357626,.64368981,63032,41427,0,0
2011,36,New York,White,79648,67030,138161,117446,95517,42644,81299,36147,.69134563,.6922245,,,0,0
2011,37,North Carolina,Asian,3382,3013,8023,7188,5582,2441,4936,2252,.6957497,.68670005,,,0,0
2011,37,North Carolina,Black,4973,4717,7981,7552,2590,5391,2374,5178,.32452074,.31435382,,,0,0
2011,37,North Carolina,Hispanic,2463,2272,4359,3990,2232,2127,1966,2024,.51204407,.49273184,,,0,0
2011,37,North Carolina,Total,49958,43463,94061,81386,57248,36813,47975,33411,.60862631,.58947486,25709,15545,0,0
2011,37,North Carolina,White,36284,30913,68667,58208,44000,24667,36275,21933,.64077359,.62319613,,,0,0
2011,38,North Dakota,Asian,48,43,86,78,62,24,56,22,.72093022,.71794873,,,0,0
2011,38,North Dakota,Black,2,2,2,2,1,1,1,1,.5,.5,,,0,0
2011,38,North Dakota,Hispanic,13,11,21,18,17,4,16,2,.80952382,.8888889,,,0,0
2011,38,North Dakota,Total,1359,1187,1823,1607,1212,611,1080,527,.66483819,.67205971,888,555,0,0
2011,38,North Dakota,White,1265,1105,1667,1471,1102,565,983,488,.66106778,.66825289,,,0,0
2011,39,Ohio,Asian,2944,2411,6545,5485,5104,1441,4304,1181,.77983195,.78468549,,,0,0
2011,39,Ohio,Black,3088,2659,4370,3702,1334,3036,1060,2642,.30526316,.28633171,,,0,0
2011,39,Ohio,Hispanic,1122,917,1829,1466,1102,727,842,624,.60251504,.57435197,,,0,0
2011,39,Ohio,Total,51530,42053,85580,69489,56140,29440,44852,24637,.65599442,.6454547,24585,15453,0,0
2011,39,Ohio,White,41622,33817,68459,55291,45867,22592,36516,18775,.66999227,.66043299,,,0,0
2011,40,Oklahoma,Asian,1081,992,2243,2083,1238,1005,1123,960,.55193937,.53912628,,,0,0
2011,40,Oklahoma,Black,909,879,1357,1309,333,1024,309,1000,.24539424,.23605806,,,0,0
2011,40,Oklahoma,Hispanic,1125,1068,1687,1589,685,1002,626,963,.40604624,.39395848,,,0,0
2011,40,Oklahoma,Total,15120,13896,25188,23103,12127,13061,10744,12359,.48145944,.46504784,7806,3892,0,0
2011,40,Oklahoma,White,9738,8822,16388,14846,8398,7990,7367,7479,.51244813,.49622795,,,0,0
2011,41,Oregon,Asian,1995,1713,3660,3171,2424,1236,2046,1125,.6622951,.64522231,,,0,0
2011,41,Oregon,Black,246,220,345,312,134,211,115,197,.3884058,.36858973,,,0,0
2011,41,Oregon,Hispanic,1350,1287,1949,1848,803,1146,745,1103,.41200617,.40313852,,,0,0
2011,41,Oregon,Total,15333,13759,24045,21462,14604,9441,12705,8757,.6073612,.59197652,7706,4719,0,0
2011,41,Oregon,White,10582,9512,16345,14613,10237,6108,8965,5648,.62630773,.61349481,,,0,0
2011,42,Pennsylvania,Asian,4912,3944,10244,8295,7091,3153,5791,2504,.69221008,.69813138,,,0,0
2011,42,Pennsylvania,Black,3667,3076,5228,4415,1207,4021,947,3468,.23087223,.21449603,,,0,0
2011,42,Pennsylvania,Hispanic,1825,1532,2934,2483,1410,1524,1170,1313,.48057261,.47120419,,,0,0
2011,42,Pennsylvania,Total,54496,44771,91599,74845,60441,31158,49124,25721,.65984344,.6563431,27357,17631,0,0
2011,42,Pennsylvania,White,41299,33911,68648,55938,48048,20600,39117,16821,.69991845,.69929206,,,0,0
2011,44,Rhode Island,Asian,309,184,607,358,398,209,217,141,.6556837,.60614526,,,0,0
2011,44,Rhode Island,Black,168,134,251,193,92,159,57,136,.36653388,.29533678,,,0,0
2011,44,Rhode Island,Hispanic,408,356,590,502,217,373,152,350,.3677966,.30278885,,,0,0
2011,44,Rhode Island,Total,4600,3099,7925,4953,5043,2882,2876,2077,.63634068,.5806582,1907,1168,0,0
2011,44,Rhode Island,White,3395,2209,5950,3562,4029,1921,2283,1279,.67714286,.64093208,,,0,0
2011,45,South Carolina,Asian,943,824,1921,1674,1317,604,1161,513,.68558043,.69354838,,,1,1
2011,45,South Carolina,Black,2570,2519,3828,3732,1150,2678,1094,2638,.30041796,.29314041,,,1,1
2011,45,South Carolina,Hispanic,708,661,1158,1064,607,551,540,524,.52417964,.50751877,,,1,1
2011,45,South Carolina,Total,20684,18766,34476,30863,19859,14617,17441,13422,.57602388,.56511033,10149,5855,1,1
2011,45,South Carolina,White,15289,13657,25721,22668,15784,9937,13729,8939,.613662,.60565555,,,1,1
2011,46,South Dakota,Asian,88,79,195,185,147,48,140,45,.75384617,.75675678,,,0,0
2011,46,South Dakota,Black,28,28,48,48,21,27,21,27,.4375,.4375,,,0,0
2011,46,South Dakota,Hispanic,43,38,73,65,43,30,39,26,.58904111,.60000002,,,0,0
2011,46,South Dakota,Total,2481,2246,4207,3867,2859,1348,2621,1246,.67958164,.67778641,1509,974,0,0
2011,46,South Dakota,White,2209,2007,3716,3418,2547,1169,2329,1089,.68541443,.68139261,,,0,0
2011,47,Tennessee,Asian,1309,972,2888,2193,1945,943,1410,783,.67347646,.64295489,,,0,0
2011,47,Tennessee,Black,3194,2973,4570,4223,1091,3479,926,3297,.23873085,.2192754,,,0,0
2011,47,Tennessee,Hispanic,845,735,1357,1165,698,659,576,589,.5143699,.49442059,,,0,0
2011,47,Tennessee,Total,22816,17694,38068,28710,22313,15755,15394,13316,.58613533,.5361895,10067,5274,0,0
2011,47,Tennessee,White,16427,12203,27547,19871,17597,9950,11835,8036,.63879913,.59559155,,,0,0
2011,48,Texas,Asian,19502,18445,44802,42603,27932,16870,26292,16311,.62345433,.61713964,,,0,0
2011,48,Texas,Black,15816,15352,26085,25299,5989,20096,5595,19704,.22959556,.22115499,,,0,0
2011,48,Texas,Hispanic,75593,73179,125694,121757,37834,87860,35769,85988,.30100083,.29377365,,,0,0
2011,48,Texas,Total,198272,186704,360735,339630,163705,197030,149221,190409,.45380959,.43936342,90673,46025,0,0
2011,48,Texas,White,76830,70021,146352,133665,84009,62343,74674,58991,.57402015,.55866534,,,0,0
2011,49,Utah,Asian,1011,868,1823,1538,1167,656,996,542,.64015359,.64759427,,,0,0
2011,49,Utah,Black,123,111,201,180,99,102,87,93,.49253732,.48333332,,,0,0
2011,49,Utah,Hispanic,1129,1021,1765,1600,910,855,834,766,.51558071,.52125001,,,0,0
2011,49,Utah,Total,18508,17017,29851,27220,20198,9653,18516,8704,.67662728,.68023515,9761,6853,0,0
2011,49,Utah,White,15355,14206,24717,22711,17192,7525,15858,6853,.69555366,.69825196,,,0,0
2011,50,Vermont,Asian,259,143,491,271,298,193,174,97,.60692465,.64206642,,,0,0
2011,50,Vermont,Black,33,29,51,46,25,26,23,23,.49019608,.5,,,0,0
2011,50,Vermont,Hispanic,38,32,58,48,26,32,23,25,.44827586,.47916666,,,0,0
2011,50,Vermont,Total,3709,3212,5986,5150,3725,2261,3211,1939,.62228531,.62349516,2061,1360,0,0
2011,50,Vermont,White,3233,2885,5140,4578,3219,1921,2860,1718,.62626457,.62472695,,,0,0
2011,51,Virginia,Asian,9013,8380,19730,18405,12489,7241,11611,6794,.63299543,.63086116,,,0,0
2011,51,Virginia,Black,7814,7535,12314,11833,3867,8447,3615,8218,.31403282,.30550155,,,0,0
2011,51,Virginia,Hispanic,4745,4437,8046,7469,4199,3847,3807,3662,.52187425,.5097068,,,0,0
2011,51,Virginia,Total,72329,66316,133831,122306,79552,54279,71510,50796,.59442133,.58468103,32212,20542,0,0
2011,51,Virginia,White,44654,40297,83065,74691,53158,29907,47174,27517,.63995665,.63158882,,,0,0
2011,53,Washington,Asian,6616,6115,12702,11811,7828,4874,7180,4631,.61628091,.60790789,,,0,0
2011,53,Washington,Black,1121,1047,1710,1597,610,1100,544,1053,.35672516,.3406387,,,0,0
2011,53,Washington,Hispanic,3057,2748,4633,4214,1693,2940,1493,2721,.36542198,.35429519,,,0,0
2011,53,Washington,Total,39328,35763,66242,60513,39935,26307,35829,24684,.60286528,.59208763,19305,11865,0,0
2011,53,Washington,White,25201,22815,41891,38068,26845,15046,24021,14047,.6408298,.63100243,,,0,0
2011,54,West Virginia,Asian,205,185,473,430,348,125,329,101,.7357294,.76511627,,,1,0
2011,54,West Virginia,Black,112,102,166,153,41,125,41,112,.24698795,.26797387,,,1,0
2011,54,West Virginia,Hispanic,96,86,165,143,90,75,77,66,.54545456,.53846157,,,1,0
2011,54,West Virginia,Total,6062,5708,9834,9202,4312,5522,3995,5207,.43847874,.43414477,3453,1483,1,0
2011,54,West Virginia,White,5386,5087,8636,8109,3655,4981,3383,4726,.42322835,.41719079,,,1,0
2011,55,Wisconsin,Asian,1581,1387,3120,2724,2101,1019,1803,921,.67339742,.66189426,,,0,0
2011,55,Wisconsin,Black,812,716,1197,1053,400,797,330,723,.33416876,.31339031,,,0,0
2011,55,Wisconsin,Hispanic,1251,1103,1934,1714,1072,862,928,786,.55429161,.54142356,,,0,0
2011,55,Wisconsin,Total,31415,28520,51486,46651,35062,16424,31517,15134,.68100065,.67559111,17280,12058,0,0
2011,55,Wisconsin,White,26637,24313,43411,39568,30315,13096,27455,12113,.69832534,.69386876,,,0,0
2011,56,Wyoming,Asian,43,43,67,67,39,28,39,28,.58208954,.58208954,,,0,0
2011,56,Wyoming,Black,10,10,20,20,11,9,11,9,.55000001,.55000001,,,0,0
2011,56,Wyoming,Hispanic,83,80,113,110,46,67,43,67,.40707964,.39090911,,,0,0
2011,56,Wyoming,Total,1375,1363,2029,2016,1082,947,1072,944,.53326762,.53174603,892,501,0,0
2011,56,Wyoming,White,1171,1163,1713,1704,918,795,911,793,.5359019,.5346244,,,0,0
2012,1,Alabama,Asian,930,806,2103,1854,1340,763,1151,703,.63718498,.62081987,,,0,0
2012,1,Alabama,Black,4155,4017,6766,6559,1068,5698,995,5564,.15784806,.15169996,,,0,0
2012,1,Alabama,Hispanic,515,469,939,865,393,546,347,518,.41853034,.40115607,,,0,0
2012,1,Alabama,Total,20028,17547,36049,31931,15154,20895,12688,19243,.42037228,.39735681,9852,4258,0,0
2012,1,Alabama,White,13504,11447,24604,21196,11688,12916,9632,11564,.4750447,.45442536,,,0,0
2012,2,Alaska,Asian,298,292,556,546,303,253,297,249,.54496402,.54395604,,,0,0
2012,2,Alaska,Black,49,48,74,71,41,33,38,33,.55405408,.53521127,,,0,0
2012,2,Alaska,Hispanic,107,105,163,159,80,83,79,80,.49079755,.49685535,,,0,0
2012,2,Alaska,Total,2682,2606,4648,4521,2962,1686,2868,1653,.63726336,.63437295,1621,1062,0,0
2012,2,Alaska,White,1870,1812,3277,3182,2214,1063,2143,1039,.67561793,.6734758,,,0,0
2012,4,Arizona,Asian,2728,2515,5767,5346,3943,1824,3652,1694,.68371773,.68312758,,,0,0
2012,4,Arizona,Black,909,838,1465,1355,580,885,533,822,.39590445,.39335793,,,0,0
2012,4,Arizona,Hispanic,7472,6950,11613,10759,4842,6771,4368,6391,.41694653,.40598568,,,0,0
2012,4,Arizona,Total,28468,25594,48254,43218,27315,20939,24079,19139,.56606704,.55715209,14407,8307,0,0
2012,4,Arizona,White,14929,13121,25547,22324,16088,9459,13952,8372,.62974125,.62497759,,,0,0
2012,5,Arkansas,Asian,796,739,1831,1729,883,948,819,910,.48225012,.47368422,,,1,1
2012,5,Arkansas,Black,3102,3070,5013,4965,495,4518,470,4495,.098743267,.094662637,,,1,1
2012,5,Arkansas,Hispanic,1713,1696,2982,2945,836,2146,813,2132,.28034875,.27606112,,,1,1
2012,5,Arkansas,Total,23655,22857,40772,39548,12932,27840,12242,27306,.31717846,.3095479,12175,4227,1,1
2012,5,Arkansas,White,16740,16093,28775,27806,10041,18734,9502,18304,.34894875,.34172481,,,1,1
2012,6,California,Asian,79207,71494,168030,151324,113622,54408,101450,49874,.67620069,.67041582,,,0,0
2012,6,California,Black,10236,9009,16734,14661,6624,10110,5572,9089,.39584079,.38005593,,,0,0
2012,6,California,Hispanic,100207,93967,168892,158059,75110,93782,68526,89533,.44472206,.43354696,,,0,0
2012,6,California,Total,320481,283051,592457,520796,358111,234346,307020,213776,.60445064,.58952063,144801,95695,0,0
2012,6,California,White,97089,80142,179109,146902,126780,52329,102369,44533,.7078371,.69685233,,,0,0
2012,8,Colorado,Asian,2491,2328,4557,4260,2896,1661,2689,1571,.6355058,.63122064,,,0,0
2012,8,Colorado,Black,1293,1232,1912,1813,671,1241,616,1197,.35094142,.33976835,,,0,0
2012,8,Colorado,Hispanic,4675,4490,6906,6593,2949,3957,2736,3857,.42701998,.4149856,,,0,0
2012,8,Colorado,Total,37438,35057,61489,57341,37239,24250,34256,23085,.6056205,.59740847,18358,11442,0,0
2012,8,Colorado,White,26042,24254,43578,40475,28258,15320,25989,14486,.64844644,.64210004,,,0,0
2012,9,Connecticut,Asian,2748,1837,6193,4044,4817,1376,3055,989,.77781367,.75544018,,,0,0
2012,9,Connecticut,Black,1439,1179,2286,1863,883,1403,616,1247,.3862642,.3306495,,,0,0
2012,9,Connecticut,Hispanic,2184,1884,3663,3122,2068,1595,1670,1452,.56456459,.53491354,,,0,0
2012,9,Connecticut,Total,29397,23340,54129,42065,39437,14692,29860,12205,.72857434,.70985377,13332,9685,0,0
2012,9,Connecticut,White,20924,16799,38205,30115,29027,9178,22538,7577,.75976968,.74839783,,,0,0
2012,10,Delaware,Asian,558,439,1276,1022,844,432,639,383,.66144198,.62524462,,,0,0
2012,10,Delaware,Black,620,536,984,860,285,699,223,637,.28963414,.25930232,,,0,0
2012,10,Delaware,Hispanic,318,273,549,469,206,343,148,321,.37522769,.31556502,,,0,0
2012,10,Delaware,Total,5781,4081,10295,7328,5609,4686,3426,3902,.54482758,.46752185,2417,1257,0,0
2012,10,Delaware,White,3885,2520,6819,4446,3968,2851,2214,2232,.58190352,.49797571,,,0,0
2012,11,District Of Columbia,Asian,217,93,466,193,314,152,90,103,.67381972,.46632123,,,1,1
2012,11,District Of Columbia,Black,2153,1840,2991,2487,541,2450,280,2207,.18087596,.11258545,,,1,1
2012,11,District Of Columbia,Hispanic,636,512,1009,789,315,694,152,637,.31219029,.19264892,,,1,1
2012,11,District Of Columbia,Total,5221,3059,8930,4684,4590,4340,1186,3498,.51399773,.25320238,1512,389,1,1
2012,11,District Of Columbia,White,1690,326,3578,776,2936,642,538,238,.82057017,.693299,,,1,1
2012,12,Florida,Asian,11469,10225,24634,21967,13851,10783,11992,9975,.56227165,.54590976,,,0,1
2012,12,Florida,Black,21589,20673,34570,33094,8058,26512,7424,25670,.23309228,.22433069,,,0,1
2012,12,Florida,Hispanic,46363,40438,81710,70738,38010,43700,31187,39551,.46518174,.44088042,,,0,1
2012,12,Florida,Total,186195,165427,333023,293828,158419,174604,133523,160305,.47569987,.45442572,76128,39306,0,1
2012,12,Florida,White,90384,79722,165034,144625,87022,78012,73783,70842,.52729738,.51016766,,,0,1
2012,13,Georgia,Asian,7644,7117,16760,15630,11335,5425,10489,5141,.67631263,.67108124,,,0,0
2012,13,Georgia,Black,16226,15673,24040,23147,6709,17331,6222,16925,.27907655,.26880375,,,0,0
2012,13,Georgia,Hispanic,5394,5072,9038,8434,4424,4614,3971,4463,.48948881,.47083235,,,0,0
2012,13,Georgia,Total,77949,69534,132266,116768,74077,58189,62908,53860,.5600608,.5387435,33647,17767,0,0
2012,13,Georgia,White,43356,36848,73861,61922,47264,26597,38579,23343,.63990468,.62302572,,,0,0
2012,15,Hawaii,Asian,4608,2957,7201,4199,3826,3375,1593,2606,.53131509,.37937605,,,0,0
2012,15,Hawaii,Black,128,109,188,155,71,117,51,104,.37765959,.32903227,,,0,0
2012,15,Hawaii,Hispanic,231,181,353,255,165,188,94,161,.4674221,.36862746,,,0,0
2012,15,Hawaii,Total,7269,4692,11290,6669,5977,5313,2599,4070,.52940655,.38971359,2905,1200,0,0
2012,15,Hawaii,White,1194,760,1912,1146,1103,809,549,597,.57688284,.47905758,,,0,0
2012,16,Idaho,Asian,232,225,509,495,365,144,354,141,.71709234,.71515149,,,0,0
2012,16,Idaho,Black,44,43,83,82,47,36,47,35,.56626505,.57317072,,,0,0
2012,16,Idaho,Hispanic,356,345,566,554,298,268,291,263,.52650177,.52527076,,,0,0
2012,16,Idaho,Total,5498,5319,9395,9124,6337,3058,6152,2972,.67450774,.67426568,3150,2115,0,0
2012,16,Idaho,White,4567,4421,7728,7502,5312,2416,5156,2346,.6873706,.6872834,,,0,0
2012,17,Illinois,Asian,9589,8686,20926,19050,15765,5161,14422,4628,.75336903,.75706035,,,0,0
2012,17,Illinois,Black,8334,7498,12457,11155,3145,9312,2674,8481,.2524685,.23971313,,,0,0
2012,17,Illinois,Hispanic,13662,12243,22242,20032,9747,12495,8668,11364,.43822497,.43270767,,,0,0
2012,17,Illinois,Total,85416,74941,152709,134267,101173,51536,88700,45567,.66252154,.66062397,40653,26461,0,0
2012,17,Illinois,White,47977,41335,87251,75336,66407,20844,57535,17801,.76110303,.76371193,,,0,0
2012,18,Indiana,Asian,1941,1667,4073,3476,2784,1289,2323,1153,.68352568,.66829687,,,1,1
2012,18,Indiana,Black,2200,2035,3297,3042,712,2585,630,2412,.2159539,.20710059,,,1,1
2012,18,Indiana,Hispanic,1990,1873,3189,2988,1133,2056,995,1993,.3552838,.33299866,,,1,1
2012,18,Indiana,Total,41302,37147,65970,58587,30865,35105,26149,32438,.46786419,.44632769,21260,9634,1,1
2012,18,Indiana,White,32999,29614,52005,46069,24795,27210,21038,25031,.47678107,.45666283,,,1,1
2012,19,Iowa,Asian,609,577,1194,1131,858,336,818,313,.71859294,.72325379,,,0,0
2012,19,Iowa,Black,234,224,343,330,130,213,123,207,.37900874,.37272727,,,0,0
2012,19,Iowa,Hispanic,407,385,596,563,282,314,260,303,.47315437,.46181172,,,0,0
2012,19,Iowa,Total,10443,9593,16413,15133,10518,5895,9686,5447,.6408335,.64005816,5542,3481,0,0
2012,19,Iowa,White,8644,7902,13418,12309,8713,4705,7992,4317,.6493516,.64928102,,,0,0
2012,20,Kansas,Asian,789,745,1535,1458,967,568,915,543,.62996745,.627572,,,0,0
2012,20,Kansas,Black,381,369,538,517,166,372,152,365,.30855018,.29400387,,,0,0
2012,20,Kansas,Hispanic,772,737,1142,1091,387,755,356,735,.33887917,.32630613,,,0,0
2012,20,Kansas,Total,9462,8796,14988,13988,9124,5864,8409,5579,.60875368,.60115814,5167,3117,0,0
2012,20,Kansas,White,6912,6374,10862,10072,7148,3714,6574,3498,.65807402,.65270054,,,0,0
2012,21,Kentucky,Asian,1030,922,2108,1880,1352,756,1202,678,.64136624,.63936168,,,0,1
2012,21,Kentucky,Black,1453,1411,2081,2014,548,1533,516,1498,.26333493,.25620654,,,0,1
2012,21,Kentucky,Hispanic,805,755,1308,1218,586,722,525,693,.44801223,.43103448,,,0,1
2012,21,Kentucky,Total,29380,26477,48506,43120,23970,24536,20287,22833,.49416566,.47047773,12218,6067,0,1
2012,21,Kentucky,White,24544,21973,40612,35855,20365,20247,17084,18771,.50145274,.4764747,,,0,1
2012,22,Louisiana,Asian,621,490,1209,954,795,414,629,325,.65756822,.65932912,,,0,0
2012,22,Louisiana,Black,1701,1513,2382,2127,459,1923,373,1754,.19269522,.17536436,,,0,0
2012,22,Louisiana,Hispanic,377,259,571,373,296,275,157,216,.51838881,.42091152,,,0,0
2012,22,Louisiana,Total,9748,6609,14685,9597,7404,7281,4088,5509,.50418794,.42596644,3931,1531,0,0
2012,22,Louisiana,White,6439,3888,9589,5467,5410,4179,2653,2814,.56418812,.4852753,,,0,0
2012,23,Maine,Asian,579,475,1107,918,627,480,519,399,.56639564,.56535947,,,0,0
2012,23,Maine,Black,102,91,152,137,69,83,61,76,.45394737,.44525549,,,0,0
2012,23,Maine,Hispanic,97,86,177,160,100,77,93,67,.56497175,.58125001,,,0,0
2012,23,Maine,Total,8249,7611,13541,12375,8120,5421,7369,5006,.59966028,.59547472,4576,2933,0,0
2012,23,Maine,White,7044,6569,11438,10558,6926,4512,6342,4216,.60552543,.60068196,,,0,0
2012,24,Maryland,Asian,7534,6909,16903,15673,12346,4557,11509,4164,.73040289,.73432016,,,0,0
2012,24,Maryland,Black,10726,9845,17052,15717,5453,11599,4862,10855,.31978655,.30934656,,,0,0
2012,24,Maryland,Hispanic,4299,3938,7458,6764,4118,3340,3613,3151,.55215877,.53415138,,,0,0
2012,24,Maryland,Total,62816,54787,116614,102354,72868,43746,62802,39552,.62486494,.61357641,26640,16327,0,0
2012,24,Maryland,White,35103,29558,65986,56108,45565,20421,38209,17899,.69052523,.68099022,,,0,0
2012,25,Massachusetts,Asian,5765,4199,11972,8697,9290,2682,6591,2106,.77597725,.75784755,,,0,0
2012,25,Massachusetts,Black,2206,1831,3479,2877,1374,2105,1015,1862,.39494106,.35279804,,,0,0
2012,25,Massachusetts,Hispanic,2889,2451,4649,3928,2412,2237,1885,2043,.51882124,.47988799,,,0,0
2012,25,Massachusetts,Total,48227,38469,85753,67510,61749,24004,47157,20353,.72007978,.69851875,22808,16251,0,0
2012,25,Massachusetts,White,33978,27400,59851,47596,44747,15104,34832,12764,.74763995,.73182619,,,0,0
2012,26,Michigan,Asian,4114,3532,8387,7244,6576,1811,5646,1598,.78407061,.77940363,,,0,0
2012,26,Michigan,Black,2580,2156,3515,2969,1102,2413,900,2069,.31351352,.30313236,,,0,0
2012,26,Michigan,Hispanic,1545,1376,2327,2071,1243,1084,1075,996,.53416413,.51907289,,,0,0
2012,26,Michigan,Total,52636,46339,84175,74057,55754,28421,48582,25475,.66235816,.65600818,26822,17262,0,0
2012,26,Michigan,White,40794,36100,64318,56774,43281,21037,37846,18928,.67292202,.66660798,,,0,0
2012,27,Minnesota,Asian,2899,2461,5572,4747,3551,2021,3016,1731,.63729364,.63534862,,,0,0
2012,27,Minnesota,Black,1157,1033,1685,1498,664,1021,573,925,.39406529,.38251001,,,0,0
2012,27,Minnesota,Hispanic,959,823,1505,1294,778,727,641,653,.51694351,.49536321,,,0,0
2012,27,Minnesota,Total,37364,32906,62023,54448,40702,21321,35438,19010,.6562404,.65085953,16780,11067,0,0
2012,27,Minnesota,White,30029,26541,49528,43656,33451,16077,29277,14379,.67539573,.67062944,,,0,0
2012,28,Mississippi,Asian,283,229,501,398,280,221,210,188,.55888224,.5276382,,,0,0
2012,28,Mississippi,Black,1582,1473,2233,2089,236,1997,211,1878,.10568742,.10100526,,,0,0
2012,28,Mississippi,Hispanic,161,137,217,182,74,143,54,128,.34101382,.29670331,,,0,0
2012,28,Mississippi,Total,6232,5121,9119,7420,3287,5832,2417,5003,.3604562,.32574123,3615,1145,0,0
2012,28,Mississippi,White,3879,3004,5694,4358,2530,3164,1818,2540,.44432735,.41716385,,,0,0
2012,29,Missouri,Asian,1288,1035,2600,2048,1899,701,1488,560,.73038459,.7265625,,,0,0
2012,29,Missouri,Black,1671,1395,2430,2003,598,1832,436,1567,.24609053,.2176735,,,0,0
2012,29,Missouri,Hispanic,588,491,935,765,511,424,395,370,.54652405,.5163399,,,0,0
2012,29,Missouri,Total,19469,15382,32093,24660,21118,10975,15643,9017,.65802509,.63434714,9235,5554,0,0
2012,29,Missouri,White,14769,11536,24304,18443,16976,7328,12519,5924,.69848585,.67879415,,,0,0
2012,30,Montana,Asian,75,63,121,106,81,40,71,35,.66942149,.66981131,,,0,0
2012,30,Montana,Black,7,7,10,10,4,6,4,6,.40000001,.40000001,,,0,0
2012,30,Montana,Hispanic,52,49,82,77,47,35,46,31,.57317072,.59740257,,,0,0
2012,30,Montana,Total,3128,2882,4844,4460,2993,1851,2752,1708,.61787778,.61704034,1913,1205,0,0
2012,30,Montana,White,2769,2562,4312,3980,2716,1596,2504,1476,.62987012,.62914574,,,0,0
2012,31,Nebraska,Asian,367,320,795,690,493,302,424,266,.62012577,.61449277,,,0,0
2012,31,Nebraska,Black,210,191,341,315,110,231,104,211,.32258064,.33015874,,,0,0
2012,31,Nebraska,Hispanic,355,339,536,510,209,327,196,314,.38992536,.38431373,,,0,0
2012,31,Nebraska,Total,5766,5103,9987,8890,5665,4322,4980,3910,.56723744,.56017995,2886,1724,0,0
2012,31,Nebraska,White,4539,3980,7861,6964,4645,3216,4073,2891,.59089172,.58486503,,,0,0
2012,32,Nevada,Asian,2264,2141,4267,4006,2036,2231,1855,2151,.47715023,.4630554,,,0,0
2012,32,Nevada,Black,599,548,950,868,283,667,263,605,.29789475,.30299538,,,0,0
2012,32,Nevada,Hispanic,2797,2676,4506,4305,1673,2833,1554,2751,.37128273,.36097562,,,0,0
2012,32,Nevada,Total,13035,12068,22377,20610,10918,11459,9844,10766,.4879117,.47763222,6890,3607,0,0
2012,32,Nevada,White,6155,5598,10734,9703,6048,4686,5406,4297,.56344324,.55714726,,,0,0
2012,33,New Hampshire,Asian,595,278,1148,523,913,235,409,114,.79529619,.78202677,,,0,0
2012,33,New Hampshire,Black,70,33,94,41,57,37,22,19,.60638297,.53658539,,,0,0
2012,33,New Hampshire,Hispanic,151,100,253,160,171,82,104,56,.67588931,.64999998,,,0,0
2012,33,New Hampshire,Total,6269,4793,10201,7545,7467,2734,5444,2101,.73198706,.72153747,3238,2430,0,0
2012,33,New Hampshire,White,5082,4135,8096,6444,5854,2242,4624,1820,.72307312,.71756673,,,0,0
2012,34,New Jersey,Asian,10775,9497,24030,21292,19150,4880,17094,4198,.79692054,.80283678,,,0,0
2012,34,New Jersey,Black,2986,2422,4654,3765,2085,2569,1624,2141,.44800171,.43134129,,,0,0
2012,34,New Jersey,Hispanic,5712,4848,8966,7652,4950,4016,4198,3454,.55208564,.54861474,,,0,0
2012,34,New Jersey,Total,55203,45546,103483,85743,75981,27502,63287,22456,.73423654,.73810107,27433,20283,0,0
2012,34,New Jersey,White,31350,25273,58043,46805,44255,13788,35944,10861,.76245195,.76795214,,,0,0
2012,35,New Mexico,Asian,399,314,830,660,492,338,367,293,.59277111,.55606061,,,0,0
2012,35,New Mexico,Black,162,138,248,208,77,171,58,150,.31048387,.27884614,,,0,0
2012,35,New Mexico,Hispanic,3513,3104,5220,4649,1682,3538,1378,3271,.32222223,.29640782,,,0,0
2012,35,New Mexico,Total,9006,7478,14369,12088,6132,8237,4777,7311,.42675203,.39518532,4815,2108,0,0
2012,35,New Mexico,White,3496,2799,5875,4820,3142,2733,2439,2381,.53480852,.50601661,,,0,0
2012,36,New York,Asian,19161,17451,37246,34102,26701,10545,24469,9633,.71688235,.71752387,,,0,0
2012,36,New York,Black,10277,8674,15405,13067,6058,9347,4999,8068,.39324895,.38256678,,,0,0
2012,36,New York,Hispanic,16679,13993,24931,21030,13064,11867,11041,9989,.52400625,.5250119,,,0,0
2012,36,New York,Total,138460,118218,237371,204113,156806,80565,134746,69367,.66059458,.66015393,64946,42627,0,0
2012,36,New York,White,80957,68377,141503,120249,100216,41287,85079,35170,.70822525,.70752358,,,0,0
2012,37,North Carolina,Asian,3738,3370,8756,7913,6250,2506,5607,2306,.71379626,.70858079,,,0,0
2012,37,North Carolina,Black,5343,5117,8720,8316,2869,5851,2649,5667,.32901376,.31854257,,,0,0
2012,37,North Carolina,Hispanic,2915,2695,5134,4703,2557,2577,2265,2438,.49805221,.4816075,,,0,0
2012,37,North Carolina,Total,53836,47231,100945,87880,61364,39581,51674,36206,.60789537,.58800638,26633,16558,0,0
2012,37,North Carolina,White,38403,32955,72166,61444,46268,25898,38224,23220,.64113295,.62209493,,,0,0
2012,38,North Dakota,Asian,69,64,119,113,86,33,83,30,.72268909,.73451328,,,0,0
2012,38,North Dakota,Black,6,6,8,8,4,4,4,4,.5,.5,,,0,0
2012,38,North Dakota,Hispanic,16,15,20,19,7,13,7,12,.34999999,.36842105,,,0,0
2012,38,North Dakota,Total,1470,1352,1934,1786,1210,724,1120,666,.62564635,.62709969,882,553,0,0
2012,38,North Dakota,White,1332,1223,1726,1588,1075,651,990,598,.62282735,.62342572,,,0,0
2012,39,Ohio,Asian,3244,2640,7403,6171,5905,1498,4926,1245,.79764962,.7982499,,,0,0
2012,39,Ohio,Black,3043,2664,4425,3862,1565,2860,1315,2547,.35367233,.34049717,,,0,0
2012,39,Ohio,Hispanic,1172,966,1876,1550,1167,709,942,608,.62206823,.60774195,,,0,0
2012,39,Ohio,Total,53811,43961,91010,73981,61077,29933,48971,25010,.67110205,.66194022,25170,16201,0,0
2012,39,Ohio,White,42853,34839,71504,57700,48705,22799,38832,18868,.68115073,.67299825,,,0,0
2012,40,Oklahoma,Asian,1119,1030,2303,2123,1276,1027,1149,974,.55405992,.54121524,,,0,0
2012,40,Oklahoma,Black,925,898,1442,1398,353,1089,327,1071,.24479888,.23390558,,,0,0
2012,40,Oklahoma,Hispanic,1044,991,1783,1678,691,1092,623,1055,.38754907,.37127534,,,0,0
2012,40,Oklahoma,Total,15176,13947,25646,23494,12578,13068,11166,12328,.49044687,.47527027,8140,4023,0,0
2012,40,Oklahoma,White,9793,8879,16496,14922,8708,7788,7665,7257,.52788556,.5136711,,,0,0
2012,41,Oregon,Asian,2028,1753,3729,3218,2467,1262,2080,1138,.66157144,.64636421,,,0,0
2012,41,Oregon,Black,261,236,373,329,148,225,133,196,.39678285,.40425533,,,0,0
2012,41,Oregon,Hispanic,1464,1399,2143,2043,911,1232,849,1194,.42510501,.41556534,,,0,0
2012,41,Oregon,Total,15842,14158,24898,22184,15275,9623,13280,8904,.6135031,.59862965,8059,5025,0,0
2012,41,Oregon,White,10868,9702,16790,14972,10623,6167,9269,5703,.63269806,.61908895,,,0,0
2012,42,Pennsylvania,Asian,5183,4203,10864,8883,7820,3044,6347,2536,.71980852,.71451086,,,0,0
2012,42,Pennsylvania,Black,3542,2928,5151,4286,1347,3804,1046,3240,.26150262,.2440504,,,0,0
2012,42,Pennsylvania,Hispanic,1999,1685,3131,2651,1572,1559,1315,1336,.50207603,.49603924,,,0,0
2012,42,Pennsylvania,Total,56929,47134,97140,80169,65717,31423,53863,26306,.67651844,.67186821,28750,18665,0,0
2012,42,Pennsylvania,White,42879,35735,72476,60150,51527,20949,42647,17503,.71095258,.70901078,,,0,0
2012,44,Rhode Island,Asian,355,203,725,399,491,234,238,161,.67724138,.59649122,,,0,0
2012,44,Rhode Island,Black,179,144,275,217,87,188,57,160,.31636363,.26267281,,,0,0
2012,44,Rhode Island,Hispanic,461,402,691,580,266,425,192,388,.38494936,.33103448,,,0,0
2012,44,Rhode Island,Total,5013,3449,8733,5700,5524,3209,3260,2440,.63254321,.57192981,2176,1302,0,0
2012,44,Rhode Island,White,3641,2437,6424,4095,4322,2102,2574,1521,.67278951,.62857145,,,0,0
2012,45,South Carolina,Asian,1101,975,2209,1946,1522,687,1328,618,.68899953,.6824255,,,1,1
2012,45,South Carolina,Black,2945,2879,4271,4156,1356,2915,1296,2860,.31749004,.3118383,,,1,1
2012,45,South Carolina,Hispanic,862,805,1340,1237,730,610,659,578,.54477614,.53274047,,,1,1
2012,45,South Carolina,Total,23540,21456,37982,34119,21906,16076,19258,14861,.57674688,.56443626,10564,6231,1,1
2012,45,South Carolina,White,17174,15402,27902,24620,17076,10826,14815,9805,.61199915,.60174656,,,1,1
2012,46,South Dakota,Asian,96,88,238,224,173,65,164,60,.72689074,.73214287,,,0,0
2012,46,South Dakota,Black,32,32,56,56,39,17,39,17,.6964286,.6964286,,,0,0
2012,46,South Dakota,Hispanic,37,34,64,59,43,21,40,19,.671875,.67796612,,,0,0
2012,46,South Dakota,Total,2642,2399,4496,4110,2964,1532,2696,1414,.65925264,.6559611,1545,1005,0,0
2012,46,South Dakota,White,2328,2108,3911,3560,2586,1325,2339,1221,.66121197,.65702248,,,0,0
2012,47,Tennessee,Asian,1530,1168,3303,2495,2314,989,1700,795,.70057523,.68136275,,,0,0
2012,47,Tennessee,Black,3239,2968,4680,4249,1166,3514,951,3298,.2491453,.22381736,,,0,0
2012,47,Tennessee,Hispanic,970,854,1537,1324,779,758,635,689,.50683147,.47960725,,,0,0
2012,47,Tennessee,Total,24924,19465,41337,31254,24957,16380,17312,13942,.6037448,.55391312,10743,5790,0,0
2012,47,Tennessee,White,18009,13557,29973,21800,19703,10270,13375,8425,.65735829,.61353213,,,0,0
2012,48,Texas,Asian,20703,19575,46984,44570,31113,15871,29293,15277,.66220415,.6572358,,,0,0
2012,48,Texas,Black,16018,15556,26134,25388,6667,19467,6274,19114,.2551083,.24712463,,,0,0
2012,48,Texas,Hispanic,79805,77152,132454,127953,43356,89098,41063,86890,.32732874,.32092252,,,0,0
2012,48,Texas,Total,207321,194954,374091,351429,179021,195070,163280,188149,.47854933,.46461731,96166,49062,0,0
2012,48,Texas,White,78540,71293,147595,134189,87844,59751,77789,56400,.59516919,.57969731,,,0,0
2012,49,Utah,Asian,1094,928,2028,1696,1325,703,1133,563,.65335304,.66804248,,,0,0
2012,49,Utah,Black,136,120,201,172,98,103,85,87,.48756218,.49418604,,,0,0
2012,49,Utah,Hispanic,1253,1145,1919,1746,1020,899,929,817,.53152686,.53207332,,,0,0
2012,49,Utah,Total,20449,18710,33017,29986,22475,10542,20556,9430,.68070996,.68551993,10439,7298,0,0
2012,49,Utah,White,16858,15521,27194,24896,18978,8216,17485,7411,.69787455,.70232165,,,0,0
2012,50,Vermont,Asian,258,133,512,286,332,180,191,95,.6484375,.6678322,,,0,0
2012,50,Vermont,Black,34,33,48,47,20,28,19,28,.41666666,.40425533,,,0,0
2012,50,Vermont,Hispanic,52,41,72,58,36,36,28,30,.5,.48275861,,,0,0
2012,50,Vermont,Total,3763,3311,6216,5453,4041,2175,3515,1938,.65009654,.64459932,2151,1425,0,0
2012,50,Vermont,White,3206,2919,5253,4776,3422,1831,3076,1700,.65143728,.64405358,,,0,0
2012,51,Virginia,Asian,9473,8796,21318,19878,14093,7225,13117,6761,.66108453,.65987521,,,0,0
2012,51,Virginia,Black,8271,7883,13326,12698,4519,8807,4204,8494,.33911151,.33107576,,,0,0
2012,51,Virginia,Hispanic,5065,4727,8956,8305,4724,4232,4272,4033,.52746761,.51438892,,,0,0
2012,51,Virginia,Total,76415,70069,145708,133283,88954,56754,80245,53038,.61049497,.60206479,33626,21524,0,0
2012,51,Virginia,White,46641,42180,89546,80756,58594,30952,52240,28516,.65434527,.64688694,,,0,0
2012,53,Washington,Asian,7094,6566,13680,12721,8602,5078,7897,4824,.62880117,.62078452,,,0,0
2012,53,Washington,Black,1214,1124,1837,1714,658,1179,588,1126,.35819271,.34305719,,,0,0
2012,53,Washington,Hispanic,3185,2864,4865,4406,1901,2964,1696,2710,.39075026,.38492963,,,0,0
2012,53,Washington,Total,42129,38308,71070,64843,43450,27620,39091,25752,.61136907,.60285616,20581,12542,0,0
2012,53,Washington,White,26781,24240,44484,40326,28767,15717,25755,14571,.64668196,.63866985,,,0,0
2012,54,West Virginia,Asian,221,190,497,432,335,162,289,143,.67404425,.66898149,,,1,0
2012,54,West Virginia,Black,130,120,195,178,59,136,51,127,.30256411,.28651685,,,1,0
2012,54,West Virginia,Hispanic,105,97,180,166,86,94,76,90,.47777778,.45783132,,,1,0
2012,54,West Virginia,Total,6585,6160,10842,10091,4706,6136,4278,5813,.43405277,.42394212,3722,1631,1,0
2012,54,West Virginia,White,5811,5458,9435,8815,3960,5475,3622,5193,.41971382,.41089052,,,1,0
2012,55,Wisconsin,Asian,1610,1411,3184,2796,2194,990,1913,883,.68907034,.6841917,,,0,0
2012,55,Wisconsin,Black,840,728,1213,1046,381,832,310,736,.31409729,.29636711,,,0,0
2012,55,Wisconsin,Hispanic,1366,1220,2143,1914,1130,1013,997,917,.52729815,.52089864,,,0,0
2012,55,Wisconsin,Total,33455,30528,55300,50488,37808,17492,34347,16141,.683689,.6803003,18076,12590,0,0
2012,55,Wisconsin,White,28231,25931,46499,42744,32686,13813,29899,12845,.70293987,.69949001,,,0,0
2012,56,Wyoming,Asian,39,39,71,71,45,26,45,26,.63380283,.63380283,,,0,0
2012,56,Wyoming,Black,7,7,10,10,4,6,4,6,.40000001,.40000001,,,0,0
2012,56,Wyoming,Hispanic,74,74,102,102,46,56,46,56,.4509804,.4509804,,,0,0
2012,56,Wyoming,Total,1404,1390,2113,2096,1195,918,1182,914,.56554663,.56393129,974,523,0,0
2012,56,Wyoming,White,1191,1177,1798,1781,1017,781,1004,777,.56562847,.56372821,,,0,0
2013,1,Alabama,Asian,1092,928,2483,2157,1533,950,1288,869,.61739832,.59712565,,,0,0
2013,1,Alabama,Black,4685,4557,7609,7397,1091,6518,1022,6375,.14338283,.13816412,,,0,0
2013,1,Alabama,Hispanic,656,599,1205,1109,472,733,411,698,.39170125,.37060416,,,0,0
2013,1,Alabama,Total,22194,19628,39916,35627,16128,23788,13587,22040,.4040485,.38136807,11086,4773,0,0
2013,1,Alabama,White,14827,12693,27018,23505,12462,14556,10382,13123,.46124807,.44169325,,,0,0
2013,2,Alaska,Asian,346,342,613,604,350,263,342,262,.57096249,.56622517,,,0,0
2013,2,Alaska,Black,57,57,77,77,31,46,31,46,.4025974,.4025974,,,0,0
2013,2,Alaska,Hispanic,144,141,232,229,139,93,136,93,.5991379,.59388644,,,0,0
2013,2,Alaska,Total,2785,2698,4570,4430,2865,1705,2753,1677,.62691468,.6214447,1645,1063,0,0
2013,2,Alaska,White,1932,1863,3187,3076,2089,1098,2002,1074,.65547538,.65084523,,,0,0
2013,4,Arizona,Asian,3153,2893,7013,6462,4708,2305,4328,2134,.67132467,.66976166,,,0,0
2013,4,Arizona,Black,1049,968,1711,1584,661,1050,598,986,.38632378,.37752524,,,0,0
2013,4,Arizona,Hispanic,8509,7931,13534,12548,5604,7930,5022,7526,.41406828,.40022314,,,0,0
2013,4,Arizona,Total,30479,27543,53138,47739,30127,23011,26529,21210,.56695771,.55570918,14980,8769,0,0
2013,4,Arizona,White,15818,13973,27698,24278,17565,10133,15191,9087,.63416129,.62571055,,,0,0
2013,5,Arkansas,Asian,926,876,2155,2050,1074,1081,1015,1035,.49837586,.49512196,,,1,1
2013,5,Arkansas,Black,3316,3283,5432,5389,527,4905,509,4880,.097017676,.094451658,,,1,1
2013,5,Arkansas,Hispanic,2048,2029,3570,3535,925,2645,899,2636,.25910366,.25431401,,,1,1
2013,5,Arkansas,Total,25140,24364,43760,42545,13933,29827,13298,29247,.31839579,.31256318,12670,4390,1,1
2013,5,Arkansas,White,17678,17038,30702,29723,10896,19806,10397,19326,.35489544,.34979644,,,1,1
2013,6,California,Asian,85757,77172,182721,164217,122878,59843,109507,54710,.67248976,.66684324,,,0,0
2013,6,California,Black,11263,9859,18889,16529,7672,11217,6437,10092,.40616232,.38943675,,,0,0
2013,6,California,Hispanic,113344,106380,194663,182344,84309,110354,76793,105551,.43310234,.42114356,,,0,0
2013,6,California,Total,337624,299026,632571,557844,376846,255725,323713,234131,.5957371,.58029306,152647,101415,0,0
2013,6,California,White,102852,85026,193132,158830,136184,56948,110299,48531,.70513433,.69444692,,,0,0
2013,8,Colorado,Asian,2936,2758,5457,5102,3443,2014,3185,1917,.63093275,.62426502,,,0,0
2013,8,Colorado,Black,1459,1405,2200,2118,767,1433,717,1401,.34863636,.3385269,,,0,0
2013,8,Colorado,Hispanic,5493,5304,8198,7881,3383,4815,3158,4723,.41266161,.40071058,,,0,0
2013,8,Colorado,Total,40590,38273,67460,63477,40285,27175,37309,26168,.59716868,.58775622,19446,12113,0,0
2013,8,Colorado,White,28279,26506,47895,44857,30854,17041,28552,16305,.64420086,.63651156,,,0,0
2013,9,Connecticut,Asian,3093,2113,6764,4456,5181,1583,3271,1185,.76596689,.73406643,,,0,0
2013,9,Connecticut,Black,1679,1366,2627,2123,1095,1532,767,1356,.41682526,.36128122,,,0,0
2013,9,Connecticut,Hispanic,2482,2118,4107,3452,2329,1778,1841,1611,.56708062,.53331405,,,0,0
2013,9,Connecticut,Total,30829,24521,56838,44148,41490,15348,31462,12686,.72996938,.71264839,14019,10432,0,0
2013,9,Connecticut,White,22268,17949,40920,32346,31201,9719,24423,7923,.76248777,.75505471,,,0,0
2013,10,Delaware,Asian,590,429,1398,1047,968,430,693,354,.69241774,.6618911,,,0,0
2013,10,Delaware,Black,802,713,1319,1192,387,932,306,886,.2934041,.25671142,,,0,0
2013,10,Delaware,Hispanic,398,345,703,613,303,400,244,369,.43100995,.39804241,,,0,0
2013,10,Delaware,Total,6127,4374,11081,8018,6089,4992,3832,4186,.54949915,.47792467,2516,1389,0,0
2013,10,Delaware,White,3998,2602,7059,4654,4159,2900,2384,2270,.58917695,.5122475,,,0,0
2013,11,District Of Columbia,Asian,279,125,570,245,379,191,97,148,.66491228,.39591837,,,1,1
2013,11,District Of Columbia,Black,2381,2072,3327,2796,608,2719,302,2494,.18274722,.10801145,,,1,1
2013,11,District Of Columbia,Hispanic,790,637,1319,1029,460,859,228,801,.34874904,.22157435,,,1,1
2013,11,District Of Columbia,Total,5674,3507,9880,5439,5015,4865,1368,4071,.50759107,.25151682,1774,445,1,1
2013,11,District Of Columbia,White,1773,405,3865,981,3105,760,631,350,.8033635,.6432212,,,1,1
2013,12,Florida,Asian,12713,11136,27219,23817,15430,11789,13033,10784,.56688344,.54721415,,,0,1
2013,12,Florida,Black,22852,21784,36816,34941,9051,27765,8172,26769,.2458442,.23387997,,,0,1
2013,12,Florida,Hispanic,51158,44190,90250,76911,43110,47140,34857,42054,.47767314,.45321214,,,0,1
2013,12,Florida,Total,192393,169818,344996,301577,166480,178516,138611,162966,.48255631,.45962059,80175,41149,0,1
2013,12,Florida,White,93203,81565,170535,148069,90639,79896,75695,72374,.53149796,.51121438,,,0,1
2013,13,Georgia,Asian,8632,8002,18759,17437,12458,6301,11496,5941,.66410792,.65928775,,,0,0
2013,13,Georgia,Black,17364,16796,25829,24903,7131,18698,6599,18304,.27608502,.26498815,,,0,0
2013,13,Georgia,Hispanic,6503,6124,10846,10111,5189,5657,4640,5471,.47842523,.45890614,,,0,0
2013,13,Georgia,Total,83156,74323,141528,125384,78543,62985,66855,58529,.55496436,.53320199,34515,18535,0,0
2013,13,Georgia,White,46523,39610,79531,66978,50621,28910,41399,25579,.63649392,.6180985,,,0,0
2013,15,Hawaii,Asian,5285,3486,8136,4973,4086,4050,1791,3182,.50221241,.36014479,,,0,0
2013,15,Hawaii,Black,160,141,220,193,83,137,71,122,.37727273,.36787564,,,0,0
2013,15,Hawaii,Hispanic,255,202,392,301,196,196,133,168,.5,.44186047,,,0,0
2013,15,Hawaii,Total,7669,5136,11741,7338,6043,5698,2797,4541,.51469213,.38116652,3095,1270,0,0
2013,15,Hawaii,White,1342,873,2117,1308,1251,866,616,692,.59093058,.47094801,,,0,0
2013,16,Idaho,Asian,309,290,660,626,443,217,418,208,.67121214,.66773164,,,0,0
2013,16,Idaho,Black,71,70,109,108,57,52,56,52,.52293581,.51851851,,,0,0
2013,16,Idaho,Hispanic,404,378,643,605,323,320,305,300,.50233281,.50413221,,,0,0
2013,16,Idaho,Total,5708,5470,9723,9401,6440,3283,6244,3157,.66234702,.66418469,3378,2238,0,0
2013,16,Idaho,White,4708,4525,7960,7723,5381,2579,5236,2487,.67600501,.67797488,,,0,0
2013,17,Illinois,Asian,10730,9717,23519,21487,17481,6038,16052,5435,.74327141,.74705637,,,0,0
2013,17,Illinois,Black,8508,7452,12694,11047,3491,9203,2955,8092,.27501181,.26749343,,,0,0
2013,17,Illinois,Hispanic,16080,14494,26718,24239,11576,15142,10341,13898,.43326595,.4266265,,,0,0
2013,17,Illinois,Total,92616,81379,167102,147437,108657,58445,95759,51678,.65024358,.64949095,43835,29016,0,0
2013,17,Illinois,White,52156,45137,95801,83232,71226,24575,62098,21134,.74347866,.74608326,,,0,0
2013,18,Indiana,Asian,2168,1872,4669,4014,3177,1492,2678,1336,.68044549,.66716492,,,1,1
2013,18,Indiana,Black,2450,2209,3661,3293,809,2852,694,2599,.22097787,.21075007,,,1,1
2013,18,Indiana,Hispanic,2237,2083,3423,3166,1278,2145,1108,2058,.3733567,.3499684,,,1,1
2013,18,Indiana,Total,42230,37760,67777,59885,33453,34324,28352,31533,.49357453,.47344077,22256,10298,1,1
2013,18,Indiana,White,33762,30149,53453,47161,26977,26476,22874,24287,.50468636,.48501942,,,1,1
2013,19,Iowa,Asian,698,659,1321,1259,917,404,875,384,.69417107,.694996,,,0,0
2013,19,Iowa,Black,325,317,520,509,222,298,213,296,.42692307,.41846758,,,0,0
2013,19,Iowa,Hispanic,465,442,714,682,335,379,314,368,.46918768,.46041057,,,0,0
2013,19,Iowa,Total,11084,10220,17628,16327,11075,6553,10221,6106,.62826186,.62601823,5707,3551,0,0
2013,19,Iowa,White,9087,8318,14276,13110,9183,5093,8420,4690,.64324743,.64225781,,,0,0
2013,20,Kansas,Asian,879,819,1620,1527,1044,576,980,547,.64444447,.64178127,,,0,0
2013,20,Kansas,Black,418,405,593,576,197,396,190,386,.33220911,.3298611,,,0,0
2013,20,Kansas,Hispanic,871,837,1291,1244,461,830,430,814,.35708752,.34565917,,,0,0
2013,20,Kansas,Total,9817,9133,15339,14323,9443,5896,8728,5595,.61562032,.60936952,5231,3177,0,0
2013,20,Kansas,White,7116,6566,11028,10209,7338,3690,6756,3453,.66539717,.66176903,,,0,0
2013,21,Kentucky,Asian,1171,1044,2346,2084,1488,858,1310,774,.63427109,.62859887,,,0,1
2013,21,Kentucky,Black,1542,1494,2209,2133,576,1633,539,1594,.26075149,.25269574,,,0,1
2013,21,Kentucky,Hispanic,945,868,1554,1405,700,854,585,820,.45045045,.41637009,,,0,1
2013,21,Kentucky,Total,31254,28075,51174,45471,25816,25358,21882,23589,.50447494,.48122978,12824,6595,0,1
2013,21,Kentucky,White,26254,23424,43018,37970,22122,20896,18617,19353,.51424986,.49030814,,,0,1
2013,22,Louisiana,Asian,834,687,1487,1230,868,619,696,534,.58372563,.56585366,,,1,0
2013,22,Louisiana,Black,2850,2538,3779,3344,657,3122,536,2808,.17385551,.16028708,,,1,0
2013,22,Louisiana,Hispanic,582,445,823,603,417,406,264,339,.50668287,.43781096,,,1,0
2013,22,Louisiana,Total,13786,10092,20328,14361,8617,11711,5070,9291,.42389807,.35303947,5516,1911,1,0
2013,22,Louisiana,White,8799,5846,13200,8386,6305,6895,3344,5042,.47765151,.39875984,,,1,0
2013,23,Maine,Asian,701,583,1288,1071,728,560,586,485,.56521738,.54715222,,,0,0
2013,23,Maine,Black,108,97,172,150,68,104,61,89,.39534885,.40666667,,,0,0
2013,23,Maine,Hispanic,132,119,226,206,125,101,114,92,.55309737,.55339807,,,0,0
2013,23,Maine,Total,8430,7792,14051,12903,8452,5599,7715,5188,.60152304,.59792298,4658,2929,0,0
2013,23,Maine,White,7275,6801,12020,11166,7329,4691,6779,4387,.60973376,.60711086,,,0,0
2013,24,Maryland,Asian,8190,7469,18572,17127,13446,5126,12462,4665,.72399312,.72762305,,,0,0
2013,24,Maryland,Black,11909,10958,19098,17583,6160,12938,5461,12122,.32254687,.3105841,,,0,0
2013,24,Maryland,Hispanic,4980,4581,8801,8075,4636,4165,4135,3940,.52675831,.51207429,,,0,0
2013,24,Maryland,Total,65060,56969,122726,108038,75524,47202,65278,42760,.61538714,.60421336,27370,17111,0,0
2013,24,Maryland,White,36213,30629,69554,59306,47433,22121,39892,19414,.68195933,.67264694,,,0,0
2013,25,Massachusetts,Asian,6590,4777,13918,10000,10804,3114,7650,2350,.77626097,.76499999,,,0,0
2013,25,Massachusetts,Black,2490,2117,3933,3356,1503,2430,1176,2180,.38215104,.35041717,,,0,0
2013,25,Massachusetts,Hispanic,3529,3016,5548,4720,2750,2798,2167,2553,.4956741,.45911017,,,0,0
2013,25,Massachusetts,Total,52151,41743,93959,74132,66459,27500,50985,23147,.70731914,.6877597,24610,17616,0,0
2013,25,Massachusetts,White,37085,29929,66223,52764,48504,17719,37918,14846,.73243433,.71863389,,,0,0
2013,26,Michigan,Asian,4605,3961,9527,8302,7397,2130,6431,1871,.77642488,.77463263,,,0,0
2013,26,Michigan,Black,2574,2239,3612,3137,1208,2404,976,2161,.33444077,.31112528,,,0,0
2013,26,Michigan,Hispanic,1704,1512,2671,2359,1450,1221,1254,1105,.54286784,.53158116,,,0,0
2013,26,Michigan,Total,55012,48695,89598,79250,59167,30431,51781,27469,.66036069,.65338802,27843,18231,0,0
2013,26,Michigan,White,42999,38202,68943,61166,46178,22765,40584,20582,.66979969,.66350585,,,0,0
2013,27,Minnesota,Asian,3244,2775,6299,5338,3971,2328,3358,1980,.63041753,.62907457,,,0,0
2013,27,Minnesota,Black,1316,1181,1959,1733,775,1184,645,1088,.39561,.37218696,,,0,0
2013,27,Minnesota,Hispanic,1075,950,1728,1498,878,850,729,769,.50810188,.48664886,,,0,0
2013,27,Minnesota,Total,38772,34249,64709,56681,42031,22678,36443,20238,.6495387,.64294916,17842,11497,0,0
2013,27,Minnesota,White,31276,27678,51871,45611,34770,17101,30326,15285,.67031676,.66488349,,,0,0
2013,28,Mississippi,Asian,322,263,594,471,327,267,241,230,.55050504,.51167727,,,0,0
2013,28,Mississippi,Black,1459,1335,2085,1923,251,1834,218,1705,.12038369,.11336453,,,0,0
2013,28,Mississippi,Hispanic,156,129,212,174,72,140,51,123,.33962265,.29310346,,,0,0
2013,28,Mississippi,Total,6069,4927,9032,7257,3330,5702,2432,4825,.36868912,.3351247,3268,1132,0,0
2013,28,Mississippi,White,3871,2972,5774,4375,2550,3224,1826,2549,.44163492,.41737142,,,0,0
2013,29,Missouri,Asian,1427,1138,3041,2403,2282,759,1794,609,.75041103,.74656677,,,0,0
2013,29,Missouri,Black,1755,1483,2485,2018,644,1841,472,1546,.25915492,.23389494,,,0,0
2013,29,Missouri,Hispanic,700,569,1103,882,625,478,459,423,.56663644,.52040815,,,0,0
2013,29,Missouri,Total,20802,16430,34248,26387,22287,11961,16623,9764,.65075332,.6299693,9541,5767,0,0
2013,29,Missouri,White,15968,12453,26163,19941,17972,8191,13329,6612,.68692428,.66842186,,,0,0
2013,30,Montana,Asian,90,77,158,137,110,48,99,38,.69620252,.72262776,,,0,0
2013,30,Montana,Black,14,14,17,17,7,10,7,10,.41176471,.41176471,,,0,0
2013,30,Montana,Hispanic,64,57,101,94,55,46,51,43,.54455447,.54255319,,,0,0
2013,30,Montana,Total,3162,2914,4868,4488,3097,1771,2869,1619,.63619554,.63926023,1873,1186,0,0
2013,30,Montana,White,2814,2608,4330,4009,2811,1519,2606,1403,.64919168,.65003741,,,0,0
2013,31,Nebraska,Asian,384,334,829,722,540,289,465,257,.65138721,.64404434,,,0,0
2013,31,Nebraska,Black,228,207,363,330,111,252,96,234,.30578512,.29090908,,,0,0
2013,31,Nebraska,Hispanic,470,446,745,703,268,477,246,457,.35973155,.34992889,,,0,0
2013,31,Nebraska,Total,6544,5773,11117,9885,6203,4914,5418,4467,.55797428,.54810321,3264,1903,0,0
2013,31,Nebraska,White,5198,4543,8787,7765,5105,3682,4446,3319,.5809719,.57256919,,,0,0
2013,32,Nevada,Asian,2642,2471,5089,4715,2564,2525,2320,2395,.5038318,.49204665,,,0,0
2013,32,Nevada,Black,704,636,1111,1001,322,789,293,708,.28982899,.29270729,,,0,0
2013,32,Nevada,Hispanic,3599,3465,5910,5662,2089,3821,1973,3689,.35346869,.34846345,,,0,0
2013,32,Nevada,Total,14509,13487,25479,23454,12467,13012,11270,12184,.48930493,.48051506,7299,3901,0,0
2013,32,Nevada,White,6742,6163,12001,10832,6849,5152,6104,4728,.57070243,.56351548,,,0,0
2013,33,New Hampshire,Asian,699,355,1364,665,1043,321,491,174,.76466274,.73834586,,,0,0
2013,33,New Hampshire,Black,86,39,137,56,70,67,33,23,.5109489,.58928573,,,0,0
2013,33,New Hampshire,Hispanic,154,110,241,166,157,84,103,63,.6514523,.62048191,,,0,0
2013,33,New Hampshire,Total,6514,5018,10596,7889,7695,2901,5686,2203,.72621745,.72075039,3309,2503,0,0
2013,33,New Hampshire,White,5366,4382,8514,6796,6165,2349,4904,1892,.72410148,.72160095,,,0,0
2013,34,New Jersey,Asian,11873,10508,26510,23663,21249,5261,19064,4599,.80154657,.80564594,,,0,0
2013,34,New Jersey,Black,3383,2667,5326,4182,2329,2997,1834,2348,.43728876,.43854615,,,0,0
2013,34,New Jersey,Hispanic,7074,5926,11224,9365,6157,5067,5231,4134,.54855669,.55856913,,,0,0
2013,34,New Jersey,Total,59073,48945,111363,92675,81320,30043,68382,24293,.73022461,.73786891,29497,21947,0,0
2013,34,New Jersey,White,33736,27426,62764,51040,47691,15073,39133,11907,.75984639,.76671237,,,0,0
2013,35,New Mexico,Asian,413,316,850,670,546,304,414,256,.64235294,.61791044,,,0,0
2013,35,New Mexico,Black,169,141,249,199,88,161,59,140,.35341364,.29648241,,,0,0
2013,35,New Mexico,Hispanic,3681,3284,5258,4678,1825,3433,1491,3187,.34709015,.31872594,,,0,0
2013,35,New Mexico,Total,8635,7169,13365,11156,5936,7429,4572,6584,.44414514,.40982431,5092,2173,0,0
2013,35,New Mexico,White,3453,2724,5739,4618,3078,2661,2308,2310,.53633034,.49978346,,,0,0
2013,36,New York,Asian,20659,18648,40248,36537,28907,11341,26295,10242,.71822202,.71968144,,,0,0
2013,36,New York,Black,11352,9455,17125,14432,6593,10532,5480,8952,.38499269,.37971175,,,0,0
2013,36,New York,Hispanic,18880,16011,28606,24340,14703,13903,12472,11868,.51398307,.51240754,,,0,0
2013,36,New York,Total,142196,121451,245002,210863,161362,83640,138622,72241,.65861505,.65740317,67034,44909,0,0
2013,36,New York,White,82592,69876,144676,123158,102844,41832,87260,35898,.71085739,.70852077,,,0,0
2013,37,North Carolina,Asian,4168,3730,9668,8739,6818,2850,6094,2645,.70521307,.69733381,,,0,0
2013,37,North Carolina,Black,5805,5512,9460,8957,3013,6447,2783,6174,.31849894,.3107067,,,0,0
2013,37,North Carolina,Hispanic,3464,3175,6109,5555,3027,3082,2640,2915,.49549845,.47524753,,,0,0
2013,37,North Carolina,Total,57120,50110,107317,93535,65304,42013,55190,38345,.60851496,.59004653,27527,17013,0,0
2013,37,North Carolina,White,40764,35040,76754,65494,49501,27253,41084,24410,.64493054,.62729412,,,0,0
2013,38,North Dakota,Asian,71,65,132,122,96,36,91,31,.72727275,.74590164,,,0,0
2013,38,North Dakota,Black,14,12,19,17,12,7,11,6,.63157892,.64705884,,,0,0
2013,38,North Dakota,Hispanic,17,16,22,21,14,8,14,7,.63636363,.66666669,,,0,0
2013,38,North Dakota,Total,1665,1466,2295,2057,1504,791,1368,689,.65533769,.66504616,1007,616,0,0
2013,38,North Dakota,White,1507,1322,2042,1822,1329,713,1203,619,.65083253,.66026342,,,0,0
2013,39,Ohio,Asian,3631,2928,8515,7026,6678,1837,5518,1508,.78426307,.78536862,,,0,0
2013,39,Ohio,Black,3500,3061,5127,4440,1834,3293,1560,2880,.35771406,.35135135,,,0,0
2013,39,Ohio,Hispanic,1386,1126,2288,1850,1426,862,1135,715,.62325174,.61351353,,,0,0
2013,39,Ohio,Total,57937,47516,99156,81012,66575,32581,53634,27378,.67141676,.66205007,26670,17343,0,0
2013,39,Ohio,White,46680,38114,78626,63875,53791,24835,43110,20765,.68413758,.67491192,,,0,0
2013,40,Oklahoma,Asian,1179,1092,2509,2342,1425,1084,1307,1035,.56795537,.55807,,,0,0
2013,40,Oklahoma,Black,1055,1017,1693,1634,447,1246,414,1220,.26402834,.25336596,,,0,0
2013,40,Oklahoma,Hispanic,1382,1308,2269,2136,838,1431,743,1393,.3693257,.34784645,,,0,0
2013,40,Oklahoma,Total,15825,14555,27015,24808,13189,13826,11613,13195,.48821026,.46811512,8228,4111,0,0
2013,40,Oklahoma,White,10102,9148,17251,15608,9134,8117,7948,7660,.52947652,.50922602,,,0,0
2013,41,Oregon,Asian,2220,1877,4022,3427,2595,1427,2153,1274,.64520139,.62824631,,,0,0
2013,41,Oregon,Black,252,222,379,333,159,220,139,194,.41952506,.41741741,,,0,0
2013,41,Oregon,Hispanic,1501,1440,2175,2068,953,1222,883,1185,.43816093,.42698258,,,0,0
2013,41,Oregon,Total,16566,14856,26158,23334,16056,10102,13966,9368,.61380839,.59852576,8382,5270,0,0
2013,41,Oregon,White,11611,10418,18056,16142,11452,6604,10021,6121,.63424903,.62080288,,,0,0
2013,42,Pennsylvania,Asian,5894,4745,12195,9904,8910,3285,7201,2703,.7306273,.72707999,,,0,0
2013,42,Pennsylvania,Black,3859,3136,5573,4543,1586,3987,1263,3280,.2845864,.27801013,,,0,0
2013,42,Pennsylvania,Hispanic,2439,2041,3842,3198,1937,1905,1569,1629,.50416452,.49061912,,,0,0
2013,42,Pennsylvania,Total,61160,50592,105120,86524,71523,33597,58665,27859,.68039382,.67802,30105,19965,0,0
2013,42,Pennsylvania,White,46524,38618,79448,65545,56691,22757,46721,18824,.71356106,.71280801,,,0,0
2013,44,Rhode Island,Asian,461,273,916,499,593,323,283,216,.64737993,.56713426,,,0,0
2013,44,Rhode Island,Black,276,239,433,368,106,327,67,301,.2448037,.18206522,,,0,0
2013,44,Rhode Island,Hispanic,728,662,1135,1005,396,739,309,696,.34889868,.30746269,,,0,0
2013,44,Rhode Island,Total,5683,4148,9824,6750,5992,3832,3689,3061,.60993487,.5465185,2494,1383,0,0
2013,44,Rhode Island,White,3957,2788,6920,4591,4672,2248,2901,1690,.67514449,.63188845,,,0,0
2013,45,South Carolina,Asian,1254,1095,2474,2156,1702,772,1492,664,.68795472,.69202226,,,1,1
2013,45,South Carolina,Black,3249,3173,4670,4548,1485,3185,1421,3127,.31798714,.31244504,,,1,1
2013,45,South Carolina,Hispanic,1082,1034,1761,1670,955,806,901,769,.54230553,.53952098,,,1,1
2013,45,South Carolina,Total,25667,23501,41246,37248,23820,17426,21150,16098,.57751054,.56781572,11332,6838,1,1
2013,45,South Carolina,White,18971,17136,30705,27318,18852,11853,16560,10758,.61397165,.60619372,,,1,1
2013,46,South Dakota,Asian,97,84,204,186,157,47,143,43,.76960784,.76881719,,,0,0
2013,46,South Dakota,Black,45,44,79,78,44,35,44,34,.55696201,.56410259,,,0,0
2013,46,South Dakota,Hispanic,62,55,88,81,50,38,46,35,.56818181,.56790125,,,0,0
2013,46,South Dakota,Total,2714,2411,4326,3904,2827,1499,2548,1356,.65349054,.65266395,1666,1016,0,0
2013,46,South Dakota,White,2388,2122,3793,3416,2498,1295,2246,1170,.65858161,.65749413,,,0,0
2013,47,Tennessee,Asian,1718,1306,3803,2881,2613,1190,1890,991,.68708915,.65602219,,,0,0
2013,47,Tennessee,Black,3156,2802,4585,4040,1371,3214,1103,2937,.29901853,.27301979,,,0,0
2013,47,Tennessee,Hispanic,1139,994,1761,1509,826,935,659,850,.46905169,.43671307,,,0,0
2013,47,Tennessee,Total,26733,20948,44583,33788,26594,17989,18506,15282,.5965054,.54770923,11308,5994,0,0
2013,47,Tennessee,White,19638,15015,32702,24094,20839,11863,14236,9858,.63723934,.5908525,,,0,0
2013,48,Texas,Asian,23430,22214,53955,51326,35500,18455,33506,17820,.65795571,.65280753,,,0,0
2013,48,Texas,Black,16928,16446,27780,26965,7229,20551,6783,20182,.26022318,.25154829,,,0,0
2013,48,Texas,Hispanic,87008,84112,146116,140919,47859,98257,45133,95786,.32754114,.3202762,,,0,0
2013,48,Texas,Total,218325,205608,398130,374219,190042,208088,173643,200576,.47733656,.46401438,101271,52167,0,0
2013,48,Texas,White,82572,75098,155802,141742,92537,63265,82177,59565,.59393972,.57976466,,,0,0
2013,49,Utah,Asian,1296,1112,2385,2036,1555,830,1355,681,.65199161,.66552061,,,0,0
2013,49,Utah,Black,168,145,256,220,124,132,105,115,.484375,.47727272,,,0,0
2013,49,Utah,Hispanic,1467,1328,2226,2003,1062,1164,949,1054,.47708896,.4737893,,,0,0
2013,49,Utah,Total,22088,20267,35721,32612,23982,11739,22057,10555,.67136979,.67634612,11269,7872,0,0
2013,49,Utah,White,18199,16817,29403,27061,20341,9062,18855,8206,.69180018,.69675916,,,0,0
2013,50,Vermont,Asian,279,151,558,311,351,207,223,88,.62903225,.71704179,,,0,0
2013,50,Vermont,Black,38,35,66,58,35,31,30,28,.530303,.51724136,,,0,0
2013,50,Vermont,Hispanic,63,49,110,88,80,30,64,24,.72727275,.72727275,,,0,0
2013,50,Vermont,Total,3746,3266,6433,5562,4367,2066,3801,1761,.67884344,.68338728,2037,1416,0,0
2013,50,Vermont,White,3280,2960,5546,4982,3800,1746,3397,1585,.68517852,.68185467,,,0,0
2013,51,Virginia,Asian,10284,9514,23422,21761,15513,7909,14407,7354,.66232604,.66205597,,,0,0
2013,51,Virginia,Black,8791,8338,14544,13758,4885,9659,4521,9237,.33587733,.32860881,,,0,0
2013,51,Virginia,Hispanic,5795,5444,10462,9785,5527,4935,5055,4730,.52829289,.51660705,,,0,0
2013,51,Virginia,Total,77528,70836,149918,136626,91562,58356,82443,54183,.61074722,.60342103,34901,22426,0,0
2013,51,Virginia,White,47618,42832,92142,82655,60351,31791,53637,29018,.65497816,.64892626,,,0,0
2013,53,Washington,Asian,7800,7231,15350,14254,9661,5689,8852,5402,.62938112,.62101865,,,0,0
2013,53,Washington,Black,1387,1289,2143,1977,781,1362,679,1298,.36444238,.34344968,,,0,0
2013,53,Washington,Hispanic,3756,3447,5792,5352,2185,3607,1982,3370,.37724447,.37032884,,,0,0
2013,53,Washington,Total,44270,40474,75915,69412,46224,29691,41518,27894,.60889155,.59813863,21593,13214,0,0
2013,53,Washington,White,28183,25633,47509,43177,30630,16879,27395,15782,.64471996,.63448131,,,0,0
2013,54,West Virginia,Asian,269,226,608,520,403,205,341,179,.66282892,.65576923,,,1,0
2013,54,West Virginia,Black,167,147,251,222,70,181,59,163,.27888447,.26576576,,,1,0
2013,54,West Virginia,Hispanic,102,93,185,168,74,111,65,103,.40000001,.38690478,,,1,0
2013,54,West Virginia,Total,6985,6344,11486,10479,4936,6550,4404,6075,.42974055,.4202691,3804,1616,1,0
2013,54,West Virginia,White,6149,5598,9977,9126,4182,5795,3747,5379,.41916409,.41058514,,,1,0
2013,55,Wisconsin,Asian,1912,1645,3720,3265,2498,1222,2192,1073,.67150539,.67136294,,,0,0
2013,55,Wisconsin,Black,1122,1013,1630,1470,452,1178,381,1089,.27730063,.25918368,,,0,0
2013,55,Wisconsin,Hispanic,1580,1429,2521,2287,1340,1181,1207,1080,.53153509,.52776563,,,0,0
2013,55,Wisconsin,Total,36829,33685,61335,56199,41508,19827,37854,18345,.67674249,.67357069,19137,13392,0,0
2013,55,Wisconsin,White,30934,28475,51426,47399,35993,15433,33028,14371,.6998989,.69680792,,,0,0
2013,56,Wyoming,Asian,49,49,91,91,63,28,63,28,.69230771,.69230771,,,0,0
2013,56,Wyoming,Black,13,13,20,20,8,12,8,12,.40000001,.40000001,,,0,0
2013,56,Wyoming,Hispanic,88,88,113,113,47,66,47,66,.4159292,.4159292,,,0,0
2013,56,Wyoming,Total,1406,1395,2050,2036,1236,814,1228,808,.60292685,.60314339,884,519,0,0
2013,56,Wyoming,White,1204,1195,1757,1745,1072,685,1066,679,.61013091,.61088824,,,0,0
2014,1,Alabama,Asian,1203,1031,2784,2415,1652,1132,1391,1024,.59339082,.57598346,,,0,0
2014,1,Alabama,Black,4953,4815,8321,8093,1244,7077,1169,6924,.14950126,.14444582,,,0,0
2014,1,Alabama,Hispanic,749,681,1350,1238,482,868,419,819,.35703704,.33844912,,,0,0
2014,1,Alabama,Total,25001,22185,45434,40648,17324,28110,14624,26024,.38130036,.3597717,12340,4881,0,0
2014,1,Alabama,White,17088,14757,31176,27277,13330,17846,11149,16128,.42757249,.40873262,,,0,0
2014,2,Alaska,Asian,394,385,711,691,371,340,360,331,.52180028,.52098405,,,0,0
2014,2,Alaska,Black,69,69,103,103,40,63,40,63,.3883495,.3883495,,,0,0
2014,2,Alaska,Hispanic,143,139,228,221,136,92,132,89,.59649122,.59728509,,,0,0
2014,2,Alaska,Total,2952,2855,5012,4874,3063,1949,2966,1908,.61113328,.60853511,1667,1048,0,0
2014,2,Alaska,White,2042,1968,3516,3418,2276,1240,2204,1214,.64732653,.64482152,,,0,0
2014,4,Arizona,Asian,3413,3124,7587,6972,5349,2238,4904,2068,.70502174,.703385,,,0,0
2014,4,Arizona,Black,1114,1042,1861,1734,731,1130,650,1084,.39279956,.37485582,,,0,0
2014,4,Arizona,Hispanic,9407,8757,14976,13922,6171,8805,5545,8377,.41205931,.39829049,,,0,0
2014,4,Arizona,Total,32673,29596,57161,51430,32618,24543,28803,22627,.57063383,.5600428,15806,9080,0,0
2014,4,Arizona,White,16611,14713,29388,25766,18813,10575,16351,9415,.64015925,.63459599,,,0,0
2014,5,Arkansas,Asian,980,931,2425,2345,1220,1205,1172,1173,.50309277,.49978679,,,1,1
2014,5,Arkansas,Black,3554,3521,5791,5739,618,5173,597,5142,.10671732,.10402509,,,1,1
2014,5,Arkansas,Hispanic,2271,2249,3831,3804,1102,2729,1081,2723,.28765336,.28417456,,,1,1
2014,5,Arkansas,Total,26265,25551,45547,44428,14775,30772,14146,30282,.3243902,.3184028,13455,4682,1,1
2014,5,Arkansas,White,18339,17753,31721,30801,11328,20393,10820,19981,.35711357,.35128731,,,1,1
2014,6,California,Asian,88841,79792,190713,170931,128812,61901,114494,56437,.67542326,.66982585,,,0,0
2014,6,California,Black,12192,10800,20578,18158,8395,12183,6987,11171,.40795997,.38478908,,,0,0
2014,6,California,Hispanic,121818,114519,211567,198465,93315,118252,85259,113206,.44106594,.42959213,,,0,0
2014,6,California,Total,352519,313365,663862,587257,396381,267481,341727,245530,.59708345,.58190364,159124,105632,0,0
2014,6,California,White,103803,86296,194831,160980,137775,57056,112100,48880,.70715135,.69635981,,,0,0
2014,8,Colorado,Asian,3176,2974,6128,5727,3965,2163,3651,2076,.64703006,.63750654,,,0,0
2014,8,Colorado,Black,1686,1632,2615,2521,951,1664,886,1635,.36367112,.35144785,,,0,0
2014,8,Colorado,Hispanic,6813,6621,10340,10018,4381,5959,4147,5871,.4236944,.41395488,,,0,0
2014,8,Colorado,Total,44027,41656,73555,69363,44396,29159,41141,28222,.60357553,.593126,20816,12944,0,0
2014,8,Colorado,White,29696,27881,50390,47216,33019,17371,30531,16685,.65526891,.64662403,,,0,0
2014,9,Connecticut,Asian,3292,2273,7164,4819,5500,1664,3611,1208,.76772755,.74932557,,,0,0
2014,9,Connecticut,Black,1924,1609,2956,2444,1260,1696,928,1516,.42625168,.3797054,,,0,0
2014,9,Connecticut,Hispanic,2802,2409,4701,3961,2701,2000,2160,1801,.57455862,.54531682,,,0,0
2014,9,Connecticut,Total,32101,25553,59128,45908,43090,16038,32686,13222,.72875798,.71198922,14737,10841,0,0
2014,9,Connecticut,White,22762,18262,41849,32862,31954,9895,24816,8046,.76355469,.75515795,,,0,0
2014,10,Delaware,Asian,651,467,1481,1057,1007,474,683,374,.67994601,.64616841,,,0,0
2014,10,Delaware,Black,866,753,1394,1233,392,1002,300,933,.28120518,.24330901,,,0,0
2014,10,Delaware,Hispanic,423,348,724,595,323,401,238,357,.4461326,.40000001,,,0,0
2014,10,Delaware,Total,6453,4584,11476,8181,6345,5131,3965,4216,.55289298,.48465958,2625,1431,0,0
2014,10,Delaware,White,4220,2774,7376,4885,4402,2974,2591,2294,.59680045,.5303992,,,0,0
2014,11,District Of Columbia,Asian,270,125,591,266,369,222,100,166,.62436551,.37593985,,,1,1
2014,11,District Of Columbia,Black,2329,2004,3466,2876,710,2756,389,2487,.20484708,.1352573,,,1,1
2014,11,District Of Columbia,Hispanic,758,590,1350,988,561,789,274,714,.41555557,.27732792,,,1,1
2014,11,District Of Columbia,Total,5619,3429,10213,5610,5293,4920,1594,4016,.51826102,.28413546,1749,446,1,1
2014,11,District Of Columbia,White,1826,444,4043,1080,3253,790,726,354,.80460054,.6722222,,,1,1
2014,12,Florida,Asian,13206,11443,29572,25574,17141,12431,14355,11219,.57963616,.56131226,,,0,1
2014,12,Florida,Black,22566,21477,37266,35298,10039,27227,9041,26257,.26938763,.2561335,,,0,1
2014,12,Florida,Hispanic,53704,46431,95597,81787,46467,49130,37696,44091,.48607174,.46090454,,,0,1
2014,12,Florida,Total,196028,172233,356964,310862,176479,180485,146578,164284,.49438879,.47152114,82204,43147,0,1
2014,12,Florida,White,94343,81894,174133,150101,94145,79988,78241,71860,.54064995,.52125567,,,0,1
2014,13,Georgia,Asian,9471,8751,20654,19105,13955,6699,12807,6298,.67565602,.67034805,,,0,0
2014,13,Georgia,Black,19091,18457,28533,27457,8000,20533,7389,20068,.28037712,.26911169,,,0,0
2014,13,Georgia,Hispanic,7462,7069,12471,11739,5615,6856,5071,6668,.45024458,.43197888,,,0,0
2014,13,Georgia,Total,89806,80413,154176,136840,86075,68101,73621,63219,.55829054,.53800792,35906,19188,0,0
2014,13,Georgia,White,49585,42283,85692,72337,55062,30630,45335,27002,.64255708,.62671936,,,0,0
2014,15,Hawaii,Asian,5257,3455,8243,5039,4373,3870,1942,3097,.53051072,.38539392,,,0,0
2014,15,Hawaii,Black,171,148,226,197,92,134,73,124,.40707964,.37055838,,,0,0
2014,15,Hawaii,Hispanic,257,212,378,306,188,190,137,169,.49735451,.44771242,,,0,0
2014,15,Hawaii,Total,7683,5157,11969,7519,6577,5392,3125,4394,.54950291,.41561377,3269,1394,0,0
2014,15,Hawaii,White,1349,898,2188,1406,1419,769,755,651,.64853746,.53698432,,,0,0
2014,16,Idaho,Asian,298,280,657,619,460,197,430,189,.70015222,.69466883,,,0,0
2014,16,Idaho,Black,65,64,109,108,56,53,55,53,.51376146,.50925928,,,0,0
2014,16,Idaho,Hispanic,389,369,638,609,328,310,320,289,.51410657,.52545154,,,0,0
2014,16,Idaho,Total,5664,5393,9556,9096,6296,3260,5997,3099,.65885305,.6593008,3382,2256,0,0
2014,16,Idaho,White,4682,4459,7774,7397,5228,2546,4978,2419,.67249805,.67297554,,,0,0
2014,17,Illinois,Asian,11466,10271,24852,22491,18674,6178,16960,5531,.75140834,.7540794,,,0,0
2014,17,Illinois,Black,9554,8488,14469,12796,4007,10462,3416,9380,.27693689,.26695842,,,0,0
2014,17,Illinois,Hispanic,18270,16579,30687,27885,13359,17328,11971,15914,.43533093,.42929891,,,0,0
2014,17,Illinois,Total,99171,87445,179579,158671,115964,63615,102148,56523,.64575481,.64377236,45412,30055,0,0
2014,17,Illinois,White,54237,47006,100420,87262,74694,25726,65132,22130,.74381596,.74639589,,,0,0
2014,18,Indiana,Asian,2339,2025,5108,4422,3529,1579,3001,1421,.69087708,.67865217,,,1,1
2014,18,Indiana,Black,2652,2374,3851,3472,921,2930,813,2659,.23915866,.23415899,,,1,1
2014,18,Indiana,Hispanic,2597,2423,4093,3819,1511,2582,1349,2470,.36916688,.35323384,,,1,1
2014,18,Indiana,Total,44390,39804,72958,64883,37149,35809,31913,32970,.50918335,.49185458,22933,11305,1,1
2014,18,Indiana,White,35119,31445,57252,50775,29937,27315,25667,25108,.52289873,.50550467,,,1,1
2014,19,Iowa,Asian,787,742,1491,1415,1012,479,971,444,.67873913,.6862191,,,0,0
2014,19,Iowa,Black,355,349,560,548,228,332,221,327,.40714285,.40328467,,,0,0
2014,19,Iowa,Hispanic,584,560,882,848,381,501,358,490,.4319728,.4221698,,,0,0
2014,19,Iowa,Total,12029,11165,18860,17526,11825,7035,10942,6584,.62698835,.62432957,6298,3854,0,0
2014,19,Iowa,White,9724,8965,15049,13878,9729,5320,8944,4934,.64648813,.64447325,,,0,0
2014,20,Kansas,Asian,905,846,1754,1657,1190,564,1124,533,.67844927,.67833436,,,0,0
2014,20,Kansas,Black,405,392,575,557,232,343,222,335,.40347826,.39856374,,,0,0
2014,20,Kansas,Hispanic,912,876,1273,1217,485,788,447,770,.38098979,.36729664,,,0,0
2014,20,Kansas,Total,9702,8977,15305,14248,9587,5718,8841,5407,.6263966,.62050813,5426,3305,0,0
2014,20,Kansas,White,6963,6383,10899,10074,7222,3677,6633,3441,.6626296,.65842766,,,0,0
2014,21,Kentucky,Asian,1240,1104,2564,2286,1698,866,1501,785,.66224647,.65660542,,,0,1
2014,21,Kentucky,Black,1535,1492,2214,2140,644,1570,615,1525,.29087624,.28738317,,,0,1
2014,21,Kentucky,Hispanic,1045,978,1693,1564,776,917,677,887,.45835793,.43286446,,,0,1
2014,21,Kentucky,Total,33589,30197,54948,48870,27729,27219,23585,25285,.50464076,.48260692,13656,6940,0,1
2014,21,Kentucky,White,28329,25311,46221,40863,23564,22657,19898,20965,.50981158,.48694417,,,0,1
2014,22,Louisiana,Asian,1023,837,1794,1495,977,817,775,720,.5445931,.51839465,,,1,0
2014,22,Louisiana,Black,3845,3455,5194,4626,860,4334,697,3929,.16557567,.15067013,,,1,0
2014,22,Louisiana,Hispanic,851,668,1253,967,515,738,318,649,.41101357,.32885212,,,1,0
2014,22,Louisiana,Total,18591,14194,26734,19955,10126,16608,6217,13738,.37876862,.31155097,7471,2298,1,0
2014,22,Louisiana,White,11886,8415,17114,11735,7418,9696,4191,7544,.43344629,.35713676,,,1,0
2014,23,Maine,Asian,677,560,1339,1115,735,604,592,523,.54891711,.53094172,,,0,0
2014,23,Maine,Black,129,113,204,174,96,108,88,86,.47058824,.50574714,,,0,0
2014,23,Maine,Hispanic,136,125,211,194,114,97,102,92,.54028434,.52577317,,,0,0
2014,23,Maine,Total,8594,7896,14666,13421,8897,5769,8101,5320,.60664123,.60360628,4682,2921,0,0
2014,23,Maine,White,7464,6926,12607,11659,7774,4833,7157,4502,.61664152,.61386055,,,0,0
2014,24,Maryland,Asian,8342,7536,18925,17203,13781,5144,12585,4618,.72819024,.73155844,,,0,0
2014,24,Maryland,Black,12459,11440,19875,18238,6771,13104,6000,12238,.34067926,.32898346,,,0,0
2014,24,Maryland,Hispanic,5215,4777,9097,8332,4926,4171,4407,3925,.54149717,.52892464,,,0,0
2014,24,Maryland,Total,66034,57750,124096,108826,76956,47140,66325,42501,.6201328,.60945916,27805,17444,0,0
2014,24,Maryland,White,36429,30836,69734,59358,47655,22079,40053,19305,.68338257,.67477006,,,0,0
2014,25,Massachusetts,Asian,6986,5108,14684,10724,11277,3407,8055,2669,.76797873,.75111896,,,0,0
2014,25,Massachusetts,Black,2814,2356,4403,3668,1748,2655,1322,2346,.39700204,.36041439,,,0,0
2014,25,Massachusetts,Hispanic,4047,3471,6434,5464,3287,3147,2594,2870,.5108797,.47474378,,,0,0
2014,25,Massachusetts,Total,55656,44777,100493,79914,70578,29915,54644,25270,.7023176,.68378508,25622,18148,0,0
2014,25,Massachusetts,White,39172,31812,70244,56485,51062,19182,40380,16105,.72692329,.71488005,,,0,0
2014,26,Michigan,Asian,4804,4183,10148,8844,7874,2274,6817,2027,.77591646,.77080506,,,0,0
2014,26,Michigan,Black,2810,2448,3849,3344,1324,2525,1068,2276,.34398544,.31937799,,,0,0
2014,26,Michigan,Hispanic,1975,1749,3078,2719,1544,1534,1325,1394,.50162441,.48731151,,,0,0
2014,26,Michigan,Total,57510,50829,94043,83041,61898,32145,54061,28980,.65818828,.65101576,28795,19007,0,0
2014,26,Michigan,White,44475,39401,71563,63364,47958,23605,42081,21283,.67015076,.66411525,,,0,0
2014,27,Minnesota,Asian,3567,3064,6926,5894,4450,2476,3733,2161,.64250648,.63335598,,,0,0
2014,27,Minnesota,Black,1486,1306,2210,1920,957,1253,807,1113,.43303168,.42031249,,,0,0
2014,27,Minnesota,Hispanic,1208,1089,1906,1697,1008,898,869,828,.52885622,.51208013,,,0,0
2014,27,Minnesota,Total,40877,36047,67830,59436,44460,23370,38738,20698,.65546221,.65175986,18118,11839,0,0
2014,27,Minnesota,White,32843,29058,54054,47613,36479,17575,32047,15566,.67486215,.67307246,,,0,0
2014,28,Mississippi,Asian,365,296,655,522,339,316,247,275,.51755726,.47318009,,,0,0
2014,28,Mississippi,Black,1818,1724,2540,2399,328,2212,289,2110,.12913387,.12046686,,,0,0
2014,28,Mississippi,Hispanic,198,161,299,238,99,200,68,170,.33110368,.2857143,,,0,0
2014,28,Mississippi,Total,7370,6171,11164,9215,4079,7085,3035,6180,.36537084,.32935432,3744,1248,0,0
2014,28,Mississippi,White,4609,3649,7118,5575,3140,3978,2296,3279,.44113514,.41183856,,,0,0
2014,29,Missouri,Asian,1543,1248,3234,2549,2457,777,1928,621,.75974023,.75637507,,,0,0
2014,29,Missouri,Black,1863,1631,2557,2186,680,1877,527,1659,.26593664,.2410796,,,0,0
2014,29,Missouri,Hispanic,739,614,1157,931,644,513,482,449,.55661196,.5177229,,,0,0
2014,29,Missouri,Total,22392,18038,36458,28621,24043,12415,18279,10342,.65947115,.63865691,10049,6102,0,0
2014,29,Missouri,White,17135,13604,27833,21578,19319,8514,14595,6983,.69410414,.67638338,,,0,0
2014,30,Montana,Asian,87,73,153,128,98,55,86,42,.6405229,.671875,,,0,0
2014,30,Montana,Black,23,23,37,37,20,17,20,17,.54054052,.54054052,,,0,0
2014,30,Montana,Hispanic,64,59,96,88,54,42,48,40,.5625,.54545456,,,0,0
2014,30,Montana,Total,3337,3118,5309,4973,3356,1953,3133,1840,.63213414,.63000202,1972,1254,0,0
2014,30,Montana,White,2981,2796,4780,4493,3063,1717,2865,1628,.64079499,.6376586,,,0,0
2014,31,Nebraska,Asian,444,367,915,774,614,301,516,258,.67103827,.66666669,,,0,0
2014,31,Nebraska,Black,199,179,325,286,97,228,82,204,.29846153,.28671327,,,0,0
2014,31,Nebraska,Hispanic,481,452,756,710,298,458,272,438,.39417988,.3830986,,,0,0
2014,31,Nebraska,Total,6405,5616,10986,9698,6211,4775,5369,4329,.5653559,.55361933,3444,1991,0,0
2014,31,Nebraska,White,5062,4414,8622,7587,5009,3613,4326,3261,.58095568,.57018584,,,0,0
2014,32,Nevada,Asian,2736,2548,5276,4892,2806,2470,2553,2339,.53184229,.52187246,,,0,0
2014,32,Nevada,Black,730,674,1201,1094,446,755,388,706,.3713572,.35466179,,,0,0
2014,32,Nevada,Hispanic,3939,3787,6578,6314,2569,4009,2431,3883,.39054424,.38501742,,,0,0
2014,32,Nevada,Total,15607,14474,27473,25347,14017,13456,12667,12680,.51021004,.49974355,7795,4304,0,0
2014,32,Nevada,White,7264,6617,12857,11659,7413,5444,6611,5048,.57657307,.56702977,,,0,0
2014,33,New Hampshire,Asian,679,348,1321,640,1053,268,498,142,.79712337,.77812499,,,0,0
2014,33,New Hampshire,Black,62,36,97,54,57,40,33,21,.58762884,.6111111,,,0,0
2014,33,New Hampshire,Hispanic,143,112,204,160,126,78,100,60,.61764705,.625,,,0,0
2014,33,New Hampshire,Total,6307,4879,10507,7892,7849,2658,5812,2080,.74702579,.73644197,3356,2490,0,0
2014,33,New Hampshire,White,5230,4256,8555,6826,6350,2205,5021,1805,.74225599,.73556989,,,0,0
2014,34,New Jersey,Asian,12463,11011,28108,24998,22725,5383,20389,4609,.80848867,.81562525,,,0,0
2014,34,New Jersey,Black,3767,2997,5810,4641,2615,3195,2107,2534,.45008606,.45399699,,,0,0
2014,34,New Jersey,Hispanic,7835,6526,12719,10619,7027,5692,5944,4675,.55248052,.55975139,,,0,0
2014,34,New Jersey,Total,62534,51884,119049,99047,86827,32222,73065,25982,.72933835,.73768008,30817,22895,0,0
2014,34,New Jersey,White,35145,28719,66151,53826,50157,15994,41152,12674,.75821984,.76453757,,,0,0
2014,35,New Mexico,Asian,439,349,904,728,580,324,445,283,.64159292,.61126375,,,0,0
2014,35,New Mexico,Black,154,123,245,196,77,168,50,146,.31428573,.25510204,,,0,0
2014,35,New Mexico,Hispanic,3933,3568,5808,5250,1994,3814,1672,3578,.34331957,.3184762,,,0,0
2014,35,New Mexico,Total,9056,7710,14238,12102,6142,8096,4835,7267,.43138081,.39952075,5149,2128,0,0
2014,35,New Mexico,White,3362,2732,5597,4563,3038,2559,2319,2244,.54279077,.50821829,,,0,0
2014,36,New York,Asian,22329,20127,42979,38815,30471,12508,27600,11215,.70897412,.71106529,,,0,0
2014,36,New York,Black,12115,10151,18487,15609,6986,11501,5816,9793,.37788716,.37260556,,,0,0
2014,36,New York,Hispanic,20113,17037,31110,26420,16221,14889,13747,12673,.5214079,.52032548,,,0,0
2014,36,New York,Total,148457,126994,256910,221074,167745,89165,144304,76770,.65293294,.65274072,68227,45830,0,0
2014,36,New York,White,84848,71970,149374,127460,105416,43958,89848,37612,.70571852,.70491135,,,0,0
2014,37,North Carolina,Asian,4741,4274,10841,9783,7337,3504,6520,3263,.67678261,.66646224,,,0,0
2014,37,North Carolina,Black,7314,6986,12033,11475,3484,8549,3186,8289,.2895371,.27764705,,,0,0
2014,37,North Carolina,Hispanic,4510,4184,7801,7174,3568,4233,3125,4049,.45737725,.43560079,,,0,0
2014,37,North Carolina,Total,63924,56587,119264,104768,68775,50489,58120,46648,.57666188,.55474955,29242,17413,0,0
2014,37,North Carolina,White,44020,38063,82638,70891,51332,31306,42607,28284,.621167,.60102129,,,0,0
2014,38,North Dakota,Asian,62,56,108,96,78,30,71,25,.72222221,.73958331,,,0,0
2014,38,North Dakota,Black,18,16,23,21,9,14,8,13,.39130434,.38095239,,,0,0
2014,38,North Dakota,Hispanic,16,16,22,22,13,9,13,9,.59090906,.59090906,,,0,0
2014,38,North Dakota,Total,1497,1272,2081,1788,1432,649,1238,550,.68813068,.69239372,920,611,0,0
2014,38,North Dakota,White,1341,1127,1839,1563,1272,567,1087,476,.69168025,.69545746,,,0,0
2014,39,Ohio,Asian,3932,3202,9206,7636,7350,1856,6112,1524,.79839236,.80041909,,,0,0
2014,39,Ohio,Black,3971,3505,5900,5213,2027,3873,1723,3490,.34355932,.33051986,,,0,0
2014,39,Ohio,Hispanic,1690,1405,2823,2326,1725,1098,1358,968,.6110521,.58383489,,,0,0
2014,39,Ohio,Total,61655,51017,106784,88000,71039,35745,57643,30357,.66525882,.65503407,28433,18097,0,0
2014,39,Ohio,White,49134,40435,83913,68725,56941,26972,46052,22673,.67857188,.67009091,,,0,0
2014,40,Oklahoma,Asian,1302,1204,2887,2710,1626,1261,1504,1206,.56321442,.55498153,,,0,0
2014,40,Oklahoma,Black,1035,1000,1713,1657,474,1239,435,1222,.27670753,.26252264,,,0,0
2014,40,Oklahoma,Hispanic,1487,1419,2472,2349,900,1572,812,1537,.36407766,.34567901,,,0,0
2014,40,Oklahoma,Total,16453,15182,28345,26092,13672,14673,12127,13965,.48234257,.46477848,8585,4239,0,0
2014,40,Oklahoma,White,10382,9433,17724,16034,9226,8498,8060,7974,.52053714,.50268179,,,0,0
2014,41,Oregon,Asian,2304,1967,4315,3725,2843,1472,2429,1296,.65886444,.65208054,,,0,0
2014,41,Oregon,Black,307,263,448,387,188,260,157,230,.41964287,.40568477,,,0,0
2014,41,Oregon,Hispanic,1693,1617,2467,2352,1131,1336,1059,1293,.45845157,.4502551,,,0,0
2014,41,Oregon,Total,17107,15270,27010,24031,16651,10359,14437,9594,.6164754,.60076571,8435,5305,0,0
2014,41,Oregon,White,11787,10508,18187,16136,11523,6664,9953,6183,.63358444,.61681956,,,0,0
2014,42,Pennsylvania,Asian,6523,5167,13595,10924,10119,3476,8212,2712,.74431777,.75173926,,,0,0
2014,42,Pennsylvania,Black,3946,3157,5826,4670,1866,3960,1492,3178,.32028836,.31948608,,,0,0
2014,42,Pennsylvania,Hispanic,2681,2269,4350,3672,2296,2054,1900,1772,.52781612,.51742917,,,0,0
2014,42,Pennsylvania,Total,64374,53153,112436,92395,77268,35168,63883,28512,.68721759,.69141185,31102,20892,0,0
2014,42,Pennsylvania,White,48827,40558,84480,69665,60302,24178,50111,19554,.7138021,.71931386,,,0,0
2014,44,Rhode Island,Asian,476,269,957,516,625,332,295,221,.65308255,.5717054,,,0,0
2014,44,Rhode Island,Black,276,233,424,354,141,283,94,260,.33254716,.26553673,,,0,0
2014,44,Rhode Island,Hispanic,763,699,1246,1129,451,795,365,764,.36195827,.32329494,,,0,0
2014,44,Rhode Island,Total,5907,4357,10331,7237,6471,3860,4150,3087,.62636727,.57344204,2658,1556,0,0
2014,44,Rhode Island,White,4129,2967,7260,4938,4991,2269,3242,1696,.68746555,.65654111,,,0,0
2014,45,South Carolina,Asian,1420,1242,2690,2327,1844,846,1586,741,.68550187,.68156427,,,1,1
2014,45,South Carolina,Black,3655,3581,5224,5099,1642,3582,1574,3525,.31431854,.30868798,,,1,1
2014,45,South Carolina,Hispanic,1221,1164,1919,1819,979,940,911,908,.51016152,.50082463,,,1,1
2014,45,South Carolina,Total,27655,25502,43968,40037,25365,18603,22631,17406,.57689685,.56525213,12057,7159,1,1
2014,45,South Carolina,White,20209,18400,32421,29137,19996,12425,17697,11440,.61676073,.60737205,,,1,1
2014,46,South Dakota,Asian,102,90,241,218,196,45,178,40,.81327802,.81651378,,,0,0
2014,46,South Dakota,Black,43,43,73,73,31,42,31,42,.42465752,.42465752,,,0,0
2014,46,South Dakota,Hispanic,77,72,131,122,71,60,65,57,.54198474,.53278691,,,0,0
2014,46,South Dakota,Total,2756,2502,4708,4322,3185,1523,2915,1407,.67650807,.6744563,1619,1053,0,0
2014,46,South Dakota,White,2417,2201,4094,3769,2805,1289,2571,1198,.68514901,.68214381,,,0,0
2014,47,Tennessee,Asian,1848,1450,4187,3255,2890,1297,2142,1113,.69023168,.65806454,,,0,1
2014,47,Tennessee,Black,3388,3087,4850,4362,1466,3384,1206,3156,.30226803,.27647868,,,0,1
2014,47,Tennessee,Hispanic,1400,1234,2210,1900,991,1219,771,1129,.44841629,.40578946,,,0,1
2014,47,Tennessee,Total,28557,22899,48080,37389,28640,19440,20488,16901,.59567386,.54796863,11832,6258,0,1
2014,47,Tennessee,White,20811,16202,34973,26413,22298,12675,15681,10732,.63757753,.59368491,,,0,1
2014,48,Texas,Asian,25688,24328,59196,56264,40017,19179,37828,18436,.67600852,.67233044,,,0,0
2014,48,Texas,Black,18925,18379,31267,30338,8472,22795,7972,22366,.27095661,.26277277,,,0,0
2014,48,Texas,Hispanic,95439,92640,161673,156847,55669,106004,52729,104118,.34433085,.33618113,,,0,0
2014,48,Texas,Total,238161,224965,434001,409523,211192,222809,194121,215402,.4866164,.47401732,107439,55673,0,0
2014,48,Texas,White,88890,81002,166017,151388,99349,66668,88758,62630,.59842664,.58629483,,,0,0
2014,49,Utah,Asian,1370,1183,2417,2080,1512,905,1310,770,.62556887,.62980771,,,0,0
2014,49,Utah,Black,188,156,280,227,139,141,110,117,.49642858,.4845815,,,0,0
2014,49,Utah,Hispanic,1678,1529,2498,2259,1185,1313,1060,1199,.47437951,.46923417,,,0,0
2014,49,Utah,Total,23142,21250,36589,33442,24588,12001,22521,10921,.67200524,.67343462,11561,8037,0,0
2014,49,Utah,White,18893,17465,29892,27525,20879,9013,19257,8268,.6984812,.69961852,,,0,0
2014,50,Vermont,Asian,268,150,539,309,353,186,240,69,.65491652,.77669901,,,0,0
2014,50,Vermont,Black,50,46,63,56,25,38,22,34,.3968254,.39285713,,,0,0
2014,50,Vermont,Hispanic,65,52,106,87,65,41,52,35,.61320752,.59770113,,,0,0
2014,50,Vermont,Total,3954,3464,6639,5783,4489,2150,3924,1859,.67615604,.67854053,2298,1628,0,0
2014,50,Vermont,White,3479,3136,5770,5186,3929,1841,3504,1682,.68093586,.67566526,,,0,0
2014,51,Virginia,Asian,10619,9793,24652,22875,16506,8146,15315,7560,.66956025,.66950822,,,0,0
2014,51,Virginia,Black,8951,8439,14861,13918,5025,9836,4615,9303,.33813336,.33158499,,,0,0
2014,51,Virginia,Hispanic,5985,5584,10984,10219,6015,4969,5505,4714,.54761469,.53870243,,,0,0
2014,51,Virginia,Total,77614,70560,152155,138095,94240,57915,84617,53478,.61936843,.61274487,35318,22870,0,0
2014,51,Virginia,White,47171,42216,92458,82583,61357,31101,54336,28247,.66362023,.65795624,,,0,0
2014,53,Washington,Asian,8536,7937,16494,15347,10424,6070,9584,5763,.63198739,.62448686,,,0,0
2014,53,Washington,Black,1641,1543,2438,2272,828,1610,722,1550,.33962265,.31778169,,,0,0
2014,53,Washington,Hispanic,4134,3807,6113,5614,2476,3637,2196,3418,.40503845,.39116496,,,0,0
2014,53,Washington,Total,47146,43280,79567,72953,48747,30820,43905,29048,.61265349,.60182583,22349,13606,0,0
2014,53,Washington,White,29279,26705,48961,44596,31866,17095,28590,16006,.65084457,.6410889,,,0,0
2014,54,West Virginia,Asian,248,217,592,535,398,194,364,171,.6722973,.68037385,,,1,0
2014,54,West Virginia,Black,177,167,250,234,85,165,78,156,.34,.33333334,,,1,0
2014,54,West Virginia,Hispanic,92,90,142,140,66,76,66,74,.46478873,.47142857,,,1,0
2014,54,West Virginia,Total,7259,6808,12022,11324,5176,6846,4799,6525,.43054399,.42379019,3817,1677,1,0
2014,54,West Virginia,White,6452,6059,10545,9956,4382,6163,4070,5886,.41555241,.40879872,,,1,0
2014,55,Wisconsin,Asian,2010,1720,4096,3552,2824,1272,2431,1121,.68945313,.68440318,,,0,0
2014,55,Wisconsin,Black,1086,959,1678,1486,506,1172,430,1056,.30154946,.28936744,,,0,0
2014,55,Wisconsin,Hispanic,1764,1594,2960,2685,1622,1338,1449,1236,.54797298,.5396648,,,0,0
2014,55,Wisconsin,Total,38431,35181,64398,59028,43864,20534,39986,19042,.68113917,.67740732,19859,13953,0,0
2014,55,Wisconsin,White,32194,29670,53529,49400,37647,15882,34551,14849,.70330101,.69941294,,,0,0
2014,56,Wyoming,Asian,51,51,100,100,70,30,70,30,.69999999,.69999999,,,0,0
2014,56,Wyoming,Black,10,10,13,13,7,6,7,6,.53846157,.53846157,,,0,0
2014,56,Wyoming,Hispanic,128,127,183,182,78,104,77,105,.42857143,.42307693,,,0,0
2014,56,Wyoming,Total,1508,1491,2246,2224,1319,927,1303,921,.58726627,.58588129,966,563,0,0
2014,56,Wyoming,White,1237,1222,1842,1822,1103,739,1088,734,.59880567,.59714597,,,0,0
2015,1,Alabama,Asian,1242,1094,2895,2564,1732,1163,1483,1081,.59827286,.57839316,,,0,0
2015,1,Alabama,Black,4786,4673,7911,7743,1228,6683,1150,6593,.1552269,.14852124,,,0,0
2015,1,Alabama,Hispanic,900,835,1684,1566,590,1094,513,1053,.35035628,.3275862,,,0,0
2015,1,Alabama,Total,26383,23785,47931,43573,18361,29570,15679,27894,.38307151,.35983291,13788,5497,0,0
2015,1,Alabama,White,18047,15897,33089,29558,13994,19095,11861,17697,.42292002,.40127885,,,0,0
2015,2,Alaska,Asian,430,425,741,731,356,385,348,383,.48043185,.47606018,,,0,0
2015,2,Alaska,Black,73,69,128,123,58,70,57,66,.453125,.46341464,,,0,0
2015,2,Alaska,Hispanic,153,150,247,243,140,107,138,105,.56680161,.56790125,,,0,0
2015,2,Alaska,Total,3355,3273,5759,5652,3402,2357,3337,2315,.59072757,.59041047,1868,1171,0,0
2015,2,Alaska,White,2279,2217,3982,3903,2529,1453,2478,1425,.63510799,.63489622,,,0,0
2015,4,Arizona,Asian,3611,3299,8532,7806,6101,2431,5580,2226,.71507269,.71483475,,,0,0
2015,4,Arizona,Black,1117,1045,1969,1822,811,1158,722,1100,.41188422,.39626783,,,0,0
2015,4,Arizona,Hispanic,10162,9502,16333,15230,6593,9740,5977,9253,.40366131,.39244911,,,0,0
2015,4,Arizona,Total,35121,31851,63103,56863,35802,27301,31669,25194,.56735814,.55693507,17169,9796,0,0
2015,4,Arizona,White,17292,15323,31751,27925,20230,11521,17613,10312,.63714528,.63072515,,,0,0
2015,5,Arkansas,Asian,1053,1009,2608,2523,1383,1225,1332,1191,.53029144,.5279429,,,1,1
2015,5,Arkansas,Black,3492,3451,5804,5750,634,5170,615,5135,.10923501,.10695652,,,1,1
2015,5,Arkansas,Hispanic,2332,2310,3986,3953,1271,2715,1252,2701,.31886604,.31672147,,,1,1
2015,5,Arkansas,Total,26500,25812,46061,45010,15018,31043,14418,30592,.3260459,.3203288,14412,5037,1,1
2015,5,Arkansas,White,17936,17391,31106,30280,11074,20032,10589,19691,.3560085,.34970278,,,1,1
2015,6,California,Asian,90189,80456,196463,175138,132556,63907,117164,57974,.6747123,.66898102,,,0,0
2015,6,California,Black,12377,10929,21374,18838,8468,12906,7057,11781,.39618227,.37461513,,,0,0
2015,6,California,Hispanic,129996,122352,228034,214228,97018,131016,88789,125439,.42545411,.4144603,,,0,0
2015,6,California,Total,370016,328955,700449,619766,409237,291212,352408,267358,.58424956,.5686146,168771,111974,0,0
2015,6,California,White,104420,86907,198295,163983,138904,59391,113136,50847,.70049167,.68992519,,,0,0
2015,8,Colorado,Asian,3394,3167,6702,6252,4451,2251,4114,2138,.66413009,.65802944,,,0,0
2015,8,Colorado,Black,1688,1626,2561,2456,995,1566,928,1528,.38852012,.37785017,,,0,0
2015,8,Colorado,Hispanic,7045,6812,10706,10309,4492,6214,4203,6106,.41957781,.407702,,,0,0
2015,8,Colorado,Total,45633,42963,77067,72270,46397,30670,42719,29551,.60203457,.59110284,22218,13906,0,0
2015,8,Colorado,White,30184,28204,52095,48533,33914,18181,31142,17391,.651003,.64166647,,,0,0
2015,9,Connecticut,Asian,3587,2454,7886,5373,5910,1976,3899,1474,.74942935,.72566539,,,0,0
2015,9,Connecticut,Black,2062,1719,3279,2669,1272,2007,875,1794,.38792315,.32783815,,,0,0
2015,9,Connecticut,Hispanic,2864,2493,4826,4120,2668,2158,2154,1966,.5528388,.52281553,,,0,0
2015,9,Connecticut,Total,33783,27101,62564,49118,44170,18394,33728,15390,.70599705,.68667293,15167,10918,0,0
2015,9,Connecticut,White,23222,18801,43099,34233,32090,11009,25152,9081,.74456483,.73472965,,,0,0
2015,10,Delaware,Asian,688,504,1563,1163,1046,517,732,431,.66922587,.62940669,,,0,0
2015,10,Delaware,Black,859,743,1337,1164,389,948,289,875,.29094988,.24828179,,,0,0
2015,10,Delaware,Hispanic,396,332,705,582,331,374,239,343,.46950355,.41065294,,,0,0
2015,10,Delaware,Total,6498,4654,11638,8338,6521,5117,4159,4179,.56031966,.49880067,2781,1425,0,0
2015,10,Delaware,White,4178,2773,7402,4923,4480,2922,2718,2205,.60524184,.55210239,,,0,0
2015,11,District Of Columbia,Asian,253,110,568,248,350,218,88,160,.61619717,.3548387,,,1,1
2015,11,District Of Columbia,Black,2371,2042,3674,3076,747,2927,397,2679,.20332064,.12906373,,,1,1
2015,11,District Of Columbia,Hispanic,843,673,1476,1147,591,885,325,822,.40040651,.28334787,,,1,1
2015,11,District Of Columbia,Total,5950,3651,10898,6127,5604,5294,1710,4417,.5142228,.27909255,1970,537,1,1
2015,11,District Of Columbia,White,1900,481,4213,1156,3410,803,770,386,.80939949,.66608995,,,1,1
2015,12,Florida,Asian,13328,11503,30021,25939,17865,12156,15057,10882,.59508342,.5804773,,,0,1
2015,12,Florida,Black,21711,20607,35989,33977,10596,25393,9602,24375,.29442328,.28260294,,,0,1
2015,12,Florida,Hispanic,54518,46891,98599,83769,49413,49186,40004,43765,.50115114,.47755137,,,0,1
2015,12,Florida,Total,200061,174851,365132,316148,184135,180997,152445,163703,.50429708,.48219505,86374,46038,0,1
2015,12,Florida,White,95092,82126,176078,150912,95729,80349,79026,71886,.54367381,.52365619,,,0,1
2015,13,Georgia,Asian,9968,9197,22369,20620,15307,7062,14032,6588,.68429524,.68050438,,,0,0
2015,13,Georgia,Black,19292,18527,28873,27587,8733,20140,8015,19572,.30246252,.29053539,,,0,0
2015,13,Georgia,Hispanic,8013,7596,13536,12742,6214,7322,5673,7069,.45907211,.44522053,,,0,0
2015,13,Georgia,Total,93208,82995,161863,142615,91413,70450,77910,64705,.56475538,.546296,38400,20615,0,0
2015,13,Georgia,White,50665,42921,88700,74200,56874,31826,46552,27648,.64119506,.62738544,,,0,0
2015,15,Hawaii,Asian,5274,3517,8541,5252,4510,4031,2083,3169,.52804118,.39661083,,,0,0
2015,15,Hawaii,Black,157,133,234,199,81,153,60,139,.34615386,.30150753,,,0,0
2015,15,Hawaii,Hispanic,259,206,359,277,162,197,109,168,.45125347,.39350182,,,0,0
2015,15,Hawaii,Total,8263,5628,13122,8265,6995,6127,3378,4887,.5330742,.40871143,3487,1441,0,0
2015,15,Hawaii,White,1356,905,2303,1437,1467,836,771,666,.6369952,.53653443,,,0,0
2015,16,Idaho,Asian,319,292,733,674,488,245,455,219,.66575718,.67507416,,,0,0
2015,16,Idaho,Black,70,70,117,117,46,71,46,71,.3931624,.3931624,,,0,0
2015,16,Idaho,Hispanic,476,449,774,732,333,441,309,423,.43023255,.42213115,,,0,0
2015,16,Idaho,Total,6151,5822,10442,9905,6431,4011,6094,3811,.61587816,.61524481,3351,2140,0,0
2015,16,Idaho,White,4911,4665,8243,7850,5260,2983,5007,2843,.63811719,.63783437,,,0,0
2015,17,Illinois,Asian,12188,10953,27285,24746,20255,7030,18364,6382,.74234927,.74209976,,,0,0
2015,17,Illinois,Black,9520,8605,14641,13200,4256,10385,3764,9436,.29069054,.28515151,,,0,0
2015,17,Illinois,Hispanic,19967,18354,34289,31660,14863,19426,13562,18098,.43346262,.42836386,,,0,0
2015,17,Illinois,Total,105205,93401,193929,172961,123135,70794,109110,63851,.63494885,.63083583,48686,32208,0,0
2015,17,Illinois,White,56876,49565,106850,93676,77773,29077,68154,25522,.72787082,.72755027,,,0,0
2015,18,Indiana,Asian,2500,2161,5607,4821,3887,1720,3291,1530,.69324058,.68263847,,,1,1
2015,18,Indiana,Black,2733,2492,4082,3707,1043,3039,899,2808,.255512,.24251416,,,1,1
2015,18,Indiana,Hispanic,2783,2604,4403,4098,1652,2751,1475,2623,.37519872,.35993168,,,1,1
2015,18,Indiana,Total,46466,41761,77086,68772,39151,37935,33735,35037,.5078873,.49053395,23707,11719,1,1
2015,18,Indiana,White,36160,32412,59424,52907,30975,28449,26678,26229,.52125406,.50424331,,,1,1
2015,19,Iowa,Asian,841,788,1614,1524,1065,549,1007,517,.65985131,.66076118,,,0,0
2015,19,Iowa,Black,384,380,578,573,213,365,211,362,.36851212,.36823735,,,0,0
2015,19,Iowa,Hispanic,671,645,1044,1001,459,585,432,569,.43965518,.43156844,,,0,0
2015,19,Iowa,Total,12449,11636,19787,18560,12445,7342,11659,6901,.62894827,.62817889,6343,4039,0,0
2015,19,Iowa,White,9897,9201,15580,14545,10211,5369,9548,4997,.65539151,.6564455,,,0,0
2015,20,Kansas,Asian,1000,925,2040,1902,1424,616,1340,562,.69803923,.70452154,,,0,0
2015,20,Kansas,Black,374,360,579,559,220,359,205,354,.37996545,.36672631,,,0,0
2015,20,Kansas,Hispanic,940,909,1418,1372,539,879,507,865,.38011283,.36953354,,,0,0
2015,20,Kansas,Total,10023,9219,16350,15177,10106,6244,9330,5847,.61810398,.61474597,5484,3295,0,0
2015,20,Kansas,White,7072,6437,11362,10471,7468,3894,6871,3600,.65727866,.65619332,,,0,0
2015,21,Kentucky,Asian,1364,1210,2831,2497,1909,922,1665,832,.67432004,.66680014,,,0,1
2015,21,Kentucky,Black,1809,1769,2551,2488,713,1838,683,1805,.27949825,.27451769,,,0,1
2015,21,Kentucky,Hispanic,1202,1125,1933,1795,850,1083,756,1039,.439731,.42116991,,,0,1
2015,21,Kentucky,Total,35069,31590,56684,50559,28505,28179,24336,26223,.50287557,.48133862,14825,7463,0,1
2015,21,Kentucky,White,28946,25898,46796,41463,23976,22820,20333,21130,.51235145,.49038902,,,0,1
2015,22,Louisiana,Asian,1132,941,2107,1761,1151,956,931,830,.5462743,.52867687,,,1,0
2015,22,Louisiana,Black,4586,4194,6132,5553,1080,5052,903,4650,.17612524,.16261481,,,1,0
2015,22,Louisiana,Hispanic,988,784,1503,1180,594,909,382,798,.39520958,.3237288,,,1,0
2015,22,Louisiana,Total,21350,16651,30751,23424,11755,18996,7599,15825,.38226399,.32441086,8921,2756,1,0
2015,22,Louisiana,White,13180,9506,19040,13299,8365,10675,4985,8314,.43933824,.3748402,,,1,0
2015,23,Maine,Asian,651,539,1306,1101,686,620,573,528,.52526802,.52043599,,,0,0
2015,23,Maine,Black,125,106,222,187,106,116,91,96,.47747749,.48663101,,,0,0
2015,23,Maine,Hispanic,130,112,239,209,131,108,117,92,.54811716,.55980861,,,0,0
2015,23,Maine,Total,8495,7806,15118,13855,9054,6064,8272,5583,.59888875,.59704077,4270,2712,0,0
2015,23,Maine,White,7264,6755,12840,11894,7850,4990,7243,4651,.61137074,.60896248,,,0,0
2015,24,Maryland,Asian,8416,7625,19387,17751,14058,5329,12937,4814,.72512507,.72880399,,,0,0
2015,24,Maryland,Black,11827,10839,19006,17462,6673,12333,5954,11508,.35109964,.34096897,,,0,0
2015,24,Maryland,Hispanic,5041,4684,8842,8181,4685,4157,4243,3938,.52985752,.51864076,,,0,0
2015,24,Maryland,Total,65109,56743,122971,107717,76148,46823,65828,41889,.61923546,.61111987,27784,17309,0,0
2015,24,Maryland,White,34929,29268,67613,57166,46122,21491,38713,18453,.68214691,.67720324,,,0,0
2015,25,Massachusetts,Asian,7195,5310,15513,11398,11683,3830,8415,2983,.75311029,.73828739,,,0,0
2015,25,Massachusetts,Black,3037,2537,4962,4121,1923,3039,1465,2656,.38754535,.35549623,,,0,0
2015,25,Massachusetts,Hispanic,4472,3873,7321,6310,3468,3853,2793,3517,.47370577,.44263074,,,0,0
2015,25,Massachusetts,Total,59105,48037,107925,86383,73589,34336,57189,29194,.68185312,.66204,27851,19359,0,0
2015,25,Massachusetts,White,40845,33535,74186,59983,52858,21328,41885,18098,.71250641,.69828117,,,0,0
2015,26,Michigan,Asian,5225,4531,10980,9614,8303,2677,7220,2394,.7561931,.75098813,,,0,0
2015,26,Michigan,Black,3030,2689,4320,3819,1503,2817,1255,2564,.34791666,.32862005,,,0,0
2015,26,Michigan,Hispanic,2078,1850,3289,2932,1681,1608,1472,1460,.51109761,.50204641,,,0,0
2015,26,Michigan,Total,59525,52463,98135,86453,63635,34500,55605,30848,.64844346,.64318186,29732,19492,0,0
2015,26,Michigan,White,45154,39822,73213,64517,48612,24601,42623,21894,.66398042,.66064757,,,0,0
2015,27,Minnesota,Asian,3828,3299,7359,6352,4702,2657,4046,2306,.63894552,.63696474,,,0,0
2015,27,Minnesota,Black,1659,1471,2365,2071,967,1398,814,1257,.40887949,.39304683,,,0,0
2015,27,Minnesota,Hispanic,1504,1306,2320,2018,1159,1161,999,1019,.49956897,.49504459,,,0,0
2015,27,Minnesota,Total,42814,37789,70699,61937,46529,24170,40662,21275,.65812814,.65650582,18865,12385,0,0
2015,27,Minnesota,White,33641,29792,55468,48740,37870,17598,33261,15479,.68273598,.68241692,,,0,0
2015,28,Mississippi,Asian,359,291,656,509,356,300,255,254,.54268295,.50098234,,,0,0
2015,28,Mississippi,Black,2110,1993,3055,2889,329,2726,292,2597,.10769231,.10107303,,,0,0
2015,28,Mississippi,Hispanic,202,174,320,277,116,204,93,184,.36250001,.33574006,,,0,0
2015,28,Mississippi,Total,7831,6561,12054,10020,4409,7645,3324,6696,.3657707,.33173653,4198,1397,0,0
2015,28,Mississippi,White,4773,3766,7460,5851,3442,4018,2553,3298,.4613941,.43633568,,,0,0
2015,29,Missouri,Asian,1635,1339,3395,2703,2480,915,1969,734,.73048604,.72844988,,,0,0
2015,29,Missouri,Black,1947,1710,2690,2330,704,1986,555,1775,.26171005,.23819743,,,0,0
2015,29,Missouri,Hispanic,852,713,1371,1112,711,660,526,586,.51859957,.4730216,,,0,0
2015,29,Missouri,Total,24164,19435,39510,31019,25263,14247,19046,11973,.63940775,.61401075,11151,6602,0,0
2015,29,Missouri,White,18300,14491,29870,23141,20184,9686,15111,8030,.67572814,.65299684,,,0,0
2015,30,Montana,Asian,76,66,143,127,96,47,84,43,.67132866,.66141731,,,0,0
2015,30,Montana,Black,12,11,28,27,19,9,19,8,.6785714,.7037037,,,0,0
2015,30,Montana,Hispanic,66,58,95,86,47,48,42,44,.49473685,.48837209,,,0,0
2015,30,Montana,Total,3247,3038,5090,4789,3169,1921,2971,1818,.62259334,.62038004,1978,1231,0,0
2015,30,Montana,White,2858,2701,4487,4252,2846,1641,2676,1576,.63427681,.6293509,,,0,0
2015,31,Nebraska,Asian,532,441,1137,948,764,373,625,323,.67194372,.65928268,,,0,0
2015,31,Nebraska,Black,227,214,371,350,143,228,134,216,.38544473,.38285714,,,0,0
2015,31,Nebraska,Hispanic,614,588,937,900,347,590,323,577,.37033084,.35888889,,,0,0
2015,31,Nebraska,Total,7395,6601,12873,11503,7367,5506,6452,5051,.57228309,.56089717,3510,2165,0,0
2015,31,Nebraska,White,5658,5020,9848,8762,5845,4003,5127,3635,.59352154,.58514041,,,0,0
2015,32,Nevada,Asian,3058,2847,6071,5618,3247,2824,2935,2683,.53483778,.52242792,,,0,0
2015,32,Nevada,Black,816,759,1427,1332,508,919,470,862,.3559916,.35285285,,,0,0
2015,32,Nevada,Hispanic,4545,4378,7917,7601,2952,4965,2793,4808,.37286851,.36745164,,,0,0
2015,32,Nevada,Total,17423,16180,31449,29012,15518,15931,13985,15027,.4934338,.48204193,8600,4734,0,0
2015,32,Nevada,White,7613,6907,13785,12405,7834,5951,6927,5478,.56829888,.55840385,,,0,0
2015,33,New Hampshire,Asian,722,368,1423,724,1078,345,532,192,.75755447,.73480666,,,0,0
2015,33,New Hampshire,Black,91,48,129,69,70,59,41,28,.54263568,.59420288,,,0,0
2015,33,New Hampshire,Hispanic,146,113,219,162,143,76,98,64,.65296805,.60493827,,,0,0
2015,33,New Hampshire,Total,6955,5390,11512,8738,8284,3228,6243,2495,.71959692,.71446556,3449,2624,0,0
2015,33,New Hampshire,White,5692,4640,9278,7456,6657,2621,5337,2119,.71750379,.71579933,,,0,0
2015,34,New Jersey,Asian,13236,11654,30454,27065,23946,6508,21403,5662,.78630066,.79079992,,,0,0
2015,34,New Jersey,Black,3920,3117,6339,4999,2765,3574,2192,2807,.43618867,.43848771,,,0,0
2015,34,New Jersey,Hispanic,8306,6952,13958,11438,7330,6628,6192,5246,.52514684,.5413534,,,0,0
2015,34,New Jersey,Total,66956,55594,129982,108265,91326,38656,76860,31405,.70260495,.7099247,32773,23961,0,0
2015,34,New Jersey,White,36689,30070,70612,57960,51554,19058,42491,15469,.73010254,.73310906,,,0,0
2015,35,New Mexico,Asian,452,344,911,717,544,367,407,310,.59714597,.56764293,,,0,0
2015,35,New Mexico,Black,163,131,266,221,79,187,60,161,.29699248,.27149323,,,0,0
2015,35,New Mexico,Hispanic,4168,3746,6333,5718,2040,4293,1689,4029,.32212222,.29538301,,,0,0
2015,35,New Mexico,Total,9314,7788,14942,12606,6010,8932,4719,7887,.40222192,.37434554,5311,2330,0,0
2015,35,New Mexico,White,3311,2658,5652,4630,2927,2725,2236,2394,.51786977,.48293737,,,0,0
2015,36,New York,Asian,23201,20901,46069,41653,31571,14498,28608,13045,.68529814,.68681729,,,0,0
2015,36,New York,Black,12827,10795,19714,16633,7107,12607,5904,10729,.36050522,.35495701,,,0,0
2015,36,New York,Hispanic,20657,17599,32184,27529,16184,16000,13794,13735,.50285858,.50107157,,,0,0
2015,36,New York,Total,153623,131452,269560,231909,170658,98902,146453,85456,.63309836,.63151062,70477,46788,0,0
2015,36,New York,White,84913,71897,152550,129873,105204,47346,89242,40631,.68963617,.68714821,,,0,0
2015,37,North Carolina,Asian,5418,4887,12778,11537,8328,4450,7343,4194,.6517452,.63647395,,,0,1
2015,37,North Carolina,Black,8930,8593,14678,14060,3919,10759,3592,10468,.26699823,.25547653,,,0,1
2015,37,North Carolina,Hispanic,5414,5114,9619,8993,4051,5568,3623,5370,.42114565,.4028689,,,0,1
2015,37,North Carolina,Total,74982,67520,140513,125348,74892,65621,63728,61620,.53298986,.50840861,33303,18646,0,1
2015,37,North Carolina,White,50349,44409,95164,83180,54965,40199,46052,37128,.57758188,.55364269,,,0,1
2015,38,North Dakota,Asian,68,57,112,91,75,37,61,30,.66964287,.67032969,,,0,0
2015,38,North Dakota,Black,17,16,24,23,9,15,9,14,.375,.39130434,,,0,0
2015,38,North Dakota,Hispanic,21,19,28,26,13,15,12,14,.4642857,.46153846,,,0,0
2015,38,North Dakota,Total,1763,1544,2438,2161,1626,812,1471,690,.66694009,.6807034,1038,722,0,0
2015,38,North Dakota,White,1584,1388,2165,1924,1458,707,1326,598,.67344111,.6891892,,,0,0
2015,39,Ohio,Asian,4198,3432,9980,8320,7784,2196,6516,1804,.77995992,.78317308,,,0,0
2015,39,Ohio,Black,4263,3727,6356,5566,2161,4195,1797,3769,.33999372,.32285303,,,0,0
2015,39,Ohio,Hispanic,1763,1453,3069,2520,1843,1226,1448,1072,.60052133,.5746032,,,0,0
2015,39,Ohio,Total,65367,53817,114370,93981,74866,39504,60561,33420,.65459472,.64439619,30269,18894,0,0
2015,39,Ohio,White,51505,42191,89099,72756,59670,29429,48120,24636,.6697045,.66138875,,,0,0
2015,40,Oklahoma,Asian,1350,1224,3038,2791,1691,1347,1518,1273,.55661619,.54389107,,,0,0
2015,40,Oklahoma,Black,1139,1097,1946,1875,533,1413,500,1375,.27389517,.26666668,,,0,0
2015,40,Oklahoma,Hispanic,1821,1766,3096,2991,1104,1992,1037,1954,.35658914,.34670678,,,0,0
2015,40,Oklahoma,Total,17336,16053,30011,27782,14031,15980,12549,15233,.46752858,.45169535,9210,4490,0,0
2015,40,Oklahoma,White,10353,9432,17702,16130,9055,8647,7982,8148,.51152414,.4948543,,,0,0
2015,41,Oregon,Asian,2489,2092,4715,4025,3107,1608,2607,1418,.65896076,.64770186,,,0,0
2015,41,Oregon,Black,293,252,467,403,173,294,145,258,.37044969,.3598015,,,0,0
2015,41,Oregon,Hispanic,2076,1973,3176,3008,1351,1825,1250,1758,.42537785,.41555852,,,0,0
2015,41,Oregon,Total,18943,16886,30672,27205,18562,12110,16099,11106,.60517734,.59176624,9015,5680,0,0
2015,41,Oregon,White,12680,11311,20183,17893,12750,7433,11094,6799,.63171977,.62001902,,,0,0
2015,42,Pennsylvania,Asian,6708,5348,14787,11943,10884,3903,8914,3029,.73605192,.74637866,,,0,0
2015,42,Pennsylvania,Black,4184,3357,6351,5132,2028,4323,1607,3525,.31931978,.31313327,,,0,0
2015,42,Pennsylvania,Hispanic,2937,2432,4790,3964,2551,2239,2077,1887,.53256786,.52396572,,,0,0
2015,42,Pennsylvania,Total,68396,56710,121013,99865,81493,39520,67744,32121,.67342353,.67835575,32824,21930,0,0
2015,42,Pennsylvania,White,51172,42729,89571,74260,62858,26713,52570,21690,.70176733,.70791811,,,0,0
2015,44,Rhode Island,Asian,498,276,1075,553,676,399,295,258,.62883723,.53345388,,,0,0
2015,44,Rhode Island,Black,301,254,471,383,163,308,102,281,.3460722,.26631853,,,0,0
2015,44,Rhode Island,Hispanic,751,689,1196,1074,477,719,402,672,.39882943,.37430167,,,0,0
2015,44,Rhode Island,Total,6281,4676,11139,7821,6840,4299,4413,3408,.61405873,.56425011,2758,1655,0,0
2015,44,Rhode Island,White,4285,3132,7688,5301,5154,2534,3363,1938,.67039543,.63440859,,,0,0
2015,45,South Carolina,Asian,1458,1273,2825,2441,1964,861,1679,762,.69522125,.68783283,,,1,1
2015,45,South Carolina,Black,3826,3742,5463,5318,1689,3774,1600,3718,.30917078,.30086499,,,1,1
2015,45,South Carolina,Hispanic,1360,1296,2093,1970,1053,1040,978,992,.50310558,.4964467,,,1,1
2015,45,South Carolina,Total,28987,26666,46341,42110,27058,19283,24102,18008,.58388901,.57235813,12969,7633,1,1
2015,45,South Carolina,White,20885,18964,33876,30400,21244,12632,18806,11594,.62711066,.61861843,,,1,1
2015,46,South Dakota,Asian,105,89,212,189,155,57,140,49,.73113209,.74074072,,,0,0
2015,46,South Dakota,Black,54,54,97,97,41,56,41,56,.42268041,.42268041,,,0,0
2015,46,South Dakota,Hispanic,87,79,137,122,64,73,54,68,.46715328,.44262296,,,0,0
2015,46,South Dakota,Total,2785,2518,4644,4230,2994,1650,2727,1503,.64470285,.64468086,1605,1031,0,0
2015,46,South Dakota,White,2406,2184,4014,3665,2645,1369,2416,1249,.65894371,.65920871,,,0,0
2015,47,Tennessee,Asian,2124,1708,4685,3708,3125,1560,2357,1351,.66702241,.63565266,,,0,1
2015,47,Tennessee,Black,3394,3117,5053,4585,1612,3441,1334,3251,.31901839,.29094875,,,0,1
2015,47,Tennessee,Hispanic,1446,1275,2333,2006,1131,1202,888,1118,.48478353,.44267198,,,0,1
2015,47,Tennessee,Total,31110,25314,52709,41724,31148,21561,22883,18841,.59094274,.54843736,12992,6934,0,1
2015,47,Tennessee,White,22593,17947,38238,29523,24095,14143,17465,12058,.63013232,.5915727,,,0,1
2015,48,Texas,Asian,28663,27211,68907,65600,44993,23914,42564,23036,.65295255,.64884144,,,0,0
2015,48,Texas,Black,21343,20716,36794,35722,9537,27257,8963,26759,.25919986,.25090981,,,0,0
2015,48,Texas,Hispanic,108910,105849,191119,185791,61275,129844,58169,127622,.32061177,.31308836,,,0,0
2015,48,Texas,Total,268918,254764,505790,478655,231124,274666,212539,266116,.45695645,.4440338,116235,59823,0,0
2015,48,Texas,White,95144,87009,184828,169038,104967,79861,93643,75395,.56791723,.553976,,,0,0
2015,49,Utah,Asian,1470,1280,2563,2224,1712,851,1484,740,.6679672,.66726619,,,0,0
2015,49,Utah,Black,194,161,280,218,142,138,101,117,.50714284,.46330276,,,0,0
2015,49,Utah,Hispanic,1863,1735,2766,2566,1390,1376,1282,1284,.50253075,.49961028,,,0,0
2015,49,Utah,Total,25035,23021,39247,35855,26304,12943,23961,11894,.67021686,.668275,12174,8434,0,0
2015,49,Utah,White,20207,18664,31773,29173,21979,9794,20136,9037,.69175088,.69022727,,,0,0
2015,50,Vermont,Asian,249,145,471,272,311,160,185,87,.66029721,.68014705,,,0,0
2015,50,Vermont,Black,55,45,92,75,47,45,43,32,.51086956,.57333332,,,0,0
2015,50,Vermont,Hispanic,74,60,133,109,82,51,69,40,.61654133,.63302749,,,0,0
2015,50,Vermont,Total,3802,3306,6414,5526,4247,2167,3641,1885,.66214532,.65888524,2341,1640,0,0
2015,50,Vermont,White,3284,2945,5506,4892,3664,1842,3226,1666,.66545588,.65944397,,,0,0
2015,51,Virginia,Asian,10834,9961,26156,24181,17538,8618,16180,8001,.67051536,.66912037,,,0,0
2015,51,Virginia,Black,8846,8332,14992,14082,5259,9733,4890,9192,.35078707,.3472518,,,0,0
2015,51,Virginia,Hispanic,6115,5721,11370,10502,6076,5294,5518,4984,.53438872,.52542371,,,0,0
2015,51,Virginia,Total,77939,70689,155426,140595,95578,59848,85590,55005,.61494213,.60876989,35208,22960,0,0
2015,51,Virginia,White,46256,41280,92365,82181,60767,31598,53647,28534,.65790069,.65279078,,,0,0
2015,53,Washington,Asian,8922,8258,17604,16304,11362,6242,10371,5933,.6454215,.63610154,,,0,0
2015,53,Washington,Black,1750,1643,2655,2459,939,1716,818,1641,.35367233,.33265555,,,0,0
2015,53,Washington,Hispanic,4416,4077,6614,6098,2679,3935,2392,3706,.40504989,.39225975,,,0,0
2015,53,Washington,Total,50268,46014,84866,77533,51725,33141,46503,31030,.60949028,.5997833,23747,14335,0,0
2015,53,Washington,White,30411,27644,50828,46116,32923,17905,29514,16602,.64773351,.6399948,,,0,0
2015,54,West Virginia,Asian,261,225,599,532,425,174,383,149,.70951587,.71992481,,,1,0
2015,54,West Virginia,Black,162,149,256,238,85,171,79,159,.33203125,.33193278,,,1,0
2015,54,West Virginia,Hispanic,117,114,199,195,91,108,89,106,.45728642,.45641026,,,1,0
2015,54,West Virginia,Total,7812,7343,12745,12004,5395,7350,5007,6997,.42330325,.41711095,4236,1764,1,0
2015,54,West Virginia,White,6896,6496,11108,10484,4518,6590,4195,6289,.4067339,.40013355,,,1,0
2015,55,Wisconsin,Asian,2163,1863,4389,3810,3002,1387,2562,1248,.68398267,.67244095,,,0,0
2015,55,Wisconsin,Black,1355,1208,1984,1768,579,1405,491,1277,.29183468,.27771494,,,0,0
2015,55,Wisconsin,Hispanic,1958,1754,3126,2809,1656,1470,1456,1353,.52975047,.51833391,,,0,0
2015,55,Wisconsin,Total,41398,37909,70007,64214,46969,23038,42828,21386,.67091864,.66695738,20837,14567,0,0
2015,55,Wisconsin,White,34266,31621,57846,53473,40120,17726,36912,16561,.69356567,.6902923,,,0,0
2015,56,Wyoming,Asian,42,42,92,92,53,39,53,39,.57608694,.57608694,,,0,0
2015,56,Wyoming,Black,8,8,11,11,4,7,4,7,.36363637,.36363637,,,0,0
2015,56,Wyoming,Hispanic,143,141,203,201,78,125,77,124,.38423645,.38308457,,,0,0
2015,56,Wyoming,Total,1767,1742,2766,2727,1513,1253,1481,1246,.54699928,.54308766,1102,612,0,0
2015,56,Wyoming,White,1460,1438,2312,2277,1302,1010,1273,1004,.5631488,.55906898,,,0,0
2016,1,Alabama,Asian,1233,1072,2844,2495,1694,1150,1426,1069,.59563994,.5715431,,,0,0
2016,1,Alabama,Black,4364,4212,7139,6902,1169,5970,1111,5791,.16374843,.16096784,,,0,0
2016,1,Alabama,Hispanic,1488,1382,2744,2544,927,1817,807,1737,.33782798,.31721699,,,0,0
2016,1,Alabama,Total,27817,24908,50959,46007,20060,30899,17109,28898,.39364979,.37187821,13878,5748,0,0
2016,1,Alabama,White,18924,16556,35051,31086,15197,19854,12813,18273,.43356824,.41217911,,,0,0
2016,2,Alaska,Asian,327,325,566,563,254,312,253,310,.44876325,.44937834,,,0,0
2016,2,Alaska,Black,57,54,90,87,39,51,37,50,.43333334,.42528737,,,0,0
2016,2,Alaska,Hispanic,279,276,439,436,221,218,221,215,.50341684,.50688076,,,0,0
2016,2,Alaska,Total,3300,3213,5589,5473,3328,2261,3267,2206,.59545535,.59693038,1896,1224,0,0
2016,2,Alaska,White,2098,2031,3639,3546,2368,1271,2316,1230,.65072823,.65313029,,,0,0
2016,4,Arizona,Asian,3333,3044,8073,7433,6031,2042,5560,1873,.74705809,.74801558,,,0,0
2016,4,Arizona,Black,983,925,1665,1553,666,999,600,953,.40000001,.38634899,,,0,0
2016,4,Arizona,Hispanic,13381,12574,21494,20150,8893,12601,8075,12075,.41374338,.40074441,,,0,0
2016,4,Arizona,Total,37176,33897,67035,60840,38254,28781,34026,26814,.57065713,.5592702,17768,10132,0,0
2016,4,Arizona,White,16917,14964,31352,27564,20340,11012,17675,9889,.64876246,.64123493,,,0,0
2016,5,Arkansas,Asian,935,889,2271,2181,1236,1035,1179,1002,.54425365,.54057771,,,1,1
2016,5,Arkansas,Black,3552,3515,5885,5828,598,5287,570,5258,.10161427,.097803704,,,1,1
2016,5,Arkansas,Hispanic,3008,2969,5085,5024,1481,3604,1443,3581,.29124877,.28722134,,,1,1
2016,5,Arkansas,Total,27444,26736,47415,46342,15719,31696,15083,31259,.33151957,.32547149,13905,5026,1,1
2016,5,Arkansas,White,17938,17389,30838,30032,11412,19426,10932,19100,.37006292,.36401173,,,1,1
2016,6,California,Asian,89819,80147,195043,173384,133312,61731,117354,56030,.68350059,.67684448,,,0,0
2016,6,California,Black,10566,9432,17769,15748,6423,11346,5297,10451,.36147222,.33636019,,,0,0
2016,6,California,Hispanic,163834,153650,285084,266861,122148,162936,111069,155792,.42846319,.41620544,,,0,0
2016,6,California,Total,393916,352031,743280,660072,429652,313628,370850,289222,.57804865,.56183267,171017,114833,0,0
2016,6,California,White,103102,85682,196861,162270,137203,59658,111433,50837,.69695371,.68671352,,,0,0
2016,8,Colorado,Asian,2908,2698,5797,5376,3966,1831,3654,1722,.684147,.6796875,,,0,0
2016,8,Colorado,Black,1475,1437,2302,2233,811,1491,775,1458,.35230234,.34706673,,,0,0
2016,8,Colorado,Hispanic,9939,9610,15343,14770,6671,8672,6249,8521,.43479112,.42308733,,,0,0
2016,8,Colorado,Total,47505,44731,80434,75424,48720,31714,44914,30510,.60571402,.59548682,22628,14150,0,0
2016,8,Colorado,White,29757,27728,51423,47779,34143,17280,31338,16441,.66396362,.65589488,,,0,0
2016,9,Connecticut,Asian,3550,2437,7896,5320,6005,1891,3942,1378,.76051164,.74097747,,,0,0
2016,9,Connecticut,Black,1855,1569,2927,2434,1046,1881,763,1671,.35736248,.31347576,,,0,0
2016,9,Connecticut,Hispanic,4045,3514,6819,5822,3810,3009,3150,2672,.55873293,.54105121,,,0,0
2016,9,Connecticut,Total,34222,27525,64134,50409,45559,18575,35105,15304,.71037203,.69640344,15505,11093,0,0
2016,9,Connecticut,White,22950,18563,43056,34166,32316,10740,25487,8679,.75055742,.74597555,,,0,0
2016,10,Delaware,Asian,689,472,1602,1146,1111,491,776,370,.69350809,.67713785,,,0,0
2016,10,Delaware,Black,818,707,1247,1071,403,844,298,773,.32317561,.27824464,,,0,0
2016,10,Delaware,Hispanic,624,525,1003,842,452,551,338,504,.45064807,.40142518,,,0,0
2016,10,Delaware,Total,6742,4851,12027,8668,6954,5073,4580,4088,.57819903,.52838027,2758,1494,0,0
2016,10,Delaware,White,4216,2831,7504,5073,4640,2864,2918,2155,.61833692,.57520205,,,0,0
2016,11,District Of Columbia,Asian,240,119,529,237,378,151,127,110,.71455574,.53586495,,,1,1
2016,11,District Of Columbia,Black,2453,2158,3691,3166,737,2954,448,2718,.19967489,.14150347,,,1,1
2016,11,District Of Columbia,Hispanic,1106,837,1938,1392,855,1083,409,983,.44117647,.29382184,,,1,1
2016,11,District Of Columbia,Total,6367,3956,11642,6565,6166,5476,2013,4552,.52963406,.30662605,2029,538,1,1
2016,11,District Of Columbia,White,2046,520,4547,1249,3691,856,876,373,.81174403,.70136106,,,1,1
2016,12,Florida,Asian,12755,10836,28536,24142,17598,10938,14406,9736,.61669469,.59671938,,,0,1
2016,12,Florida,Black,21598,20476,34947,33004,9673,25274,8755,24249,.27679056,.26527089,,,0,1
2016,12,Florida,Hispanic,70273,60308,123329,104246,61820,61509,49898,54348,.50126088,.47865626,,,0,1
2016,12,Florida,Total,207817,180897,377517,324738,191987,185530,157650,167088,.50855196,.4854683,84986,47242,0,1
2016,12,Florida,White,90644,78015,169340,144348,92951,76389,76115,68233,.54890162,.52730209,,,0,1
2016,13,Georgia,Asian,10310,9505,23371,21538,16422,6949,15096,6442,.70266569,.70090073,,,0,0
2016,13,Georgia,Black,18921,18162,28433,27093,8985,19448,8235,18858,.31600603,.30395305,,,0,0
2016,13,Georgia,Hispanic,11026,10378,18256,17078,8532,9724,7732,9346,.46735319,.45274621,,,0,0
2016,13,Georgia,Total,97571,86739,170743,149984,98526,72217,84019,65965,.5770427,.56018645,38951,21609,0,0
2016,13,Georgia,White,51765,43613,91449,75884,59658,31791,48609,27275,.6523636,.64056981,,,0,0
2016,15,Hawaii,Asian,3740,2599,6218,4009,3261,2957,1653,2356,.52444518,.41232228,,,0,0
2016,15,Hawaii,Black,82,72,130,107,49,81,32,75,.37692308,.29906541,,,0,0
2016,15,Hawaii,Hispanic,1229,906,1804,1307,764,1040,450,857,.42350334,.34429991,,,0,0
2016,15,Hawaii,Total,8898,5957,14222,8970,7389,6833,3635,5335,.51954716,.4052397,3767,1644,0,0
2016,15,Hawaii,White,1104,676,1882,1112,1194,688,570,542,.63443148,.51258993,,,0,0
2016,16,Idaho,Asian,272,246,659,613,452,207,426,187,.68588769,.69494289,,,0,0
2016,16,Idaho,Black,53,52,105,104,35,70,35,69,.33333334,.33653846,,,0,0
2016,16,Idaho,Hispanic,718,678,1129,1059,574,555,526,533,.50841451,.49669498,,,0,0
2016,16,Idaho,Total,6756,6388,11297,10727,7064,4233,6709,4018,.62529874,.62543118,3619,2349,0,0
2016,16,Idaho,White,5284,5008,8708,8302,5597,3111,5349,2953,.64274228,.64430261,,,0,0
2016,17,Illinois,Asian,12487,11213,27767,25138,20726,7041,18852,6286,.74642563,.74994034,,,0,0
2016,17,Illinois,Black,9314,8357,14183,12708,4119,10064,3609,9099,.29041812,.28399435,,,0,0
2016,17,Illinois,Hispanic,25373,23255,42997,39336,20072,22925,18261,21075,.46682328,.46423125,,,0,0
2016,17,Illinois,Total,112917,100473,207679,185275,133195,74484,118419,66856,.64135033,.63915259,49963,33428,0,0
2016,17,Illinois,White,59818,52309,112354,98737,81778,30576,71877,26860,.72786015,.72796416,,,0,0
2016,18,Indiana,Asian,2517,2163,5710,4883,3967,1743,3348,1535,.69474608,.68564409,,,1,1
2016,18,Indiana,Black,2686,2442,4094,3719,983,3111,841,2878,.24010748,.22613606,,,1,1
2016,18,Indiana,Hispanic,3940,3682,6334,5873,2369,3965,2091,3782,.37401327,.3560361,,,1,1
2016,18,Indiana,Total,48803,43922,81952,73117,41311,40641,35601,37516,.50408775,.48690456,24140,11904,1,1
2016,18,Indiana,White,37052,33291,61536,54835,31991,29545,27600,27235,.51987457,.50332814,,,1,1
2016,19,Iowa,Asian,853,800,1659,1573,1133,526,1066,507,.68294156,.67768598,,,0,0
2016,19,Iowa,Black,390,384,561,550,186,375,178,372,.33155081,.32363635,,,0,0
2016,19,Iowa,Hispanic,1066,1023,1661,1596,742,919,695,901,.44671884,.43546367,,,0,0
2016,19,Iowa,Total,13267,12429,21081,19774,12830,8251,11948,7826,.60860491,.60422778,6680,4203,0,0
2016,19,Iowa,White,10198,9482,16047,14940,10140,5907,9406,5534,.63189381,.62958503,,,0,0
2016,20,Kansas,Asian,992,899,1976,1823,1402,574,1296,527,.70951414,.7109161,,,0,0
2016,20,Kansas,Black,285,277,426,416,143,283,141,275,.33568075,.33894232,,,0,0
2016,20,Kansas,Hispanic,1262,1206,1874,1792,716,1158,661,1131,.38207045,.36886162,,,0,0
2016,20,Kansas,Total,10363,9501,16703,15421,10325,6378,9482,5939,.61815244,.61487579,5659,3430,0,0
2016,20,Kansas,White,7091,6433,11272,10296,7448,3824,6803,3493,.6607523,.66074204,,,0,0
2016,21,Kentucky,Asian,1271,1110,2809,2459,1898,911,1634,825,.67568529,.66449779,,,0,1
2016,21,Kentucky,Black,1629,1578,2404,2319,679,1725,633,1686,.28244594,.27296248,,,0,1
2016,21,Kentucky,Hispanic,1582,1481,2562,2370,1131,1431,1000,1370,.441452,.42194092,,,0,1
2016,21,Kentucky,Total,34233,30728,56289,49919,28852,27437,24388,25531,.51256907,.48855147,14706,7419,0,1
2016,21,Kentucky,White,27698,24637,45327,39823,23739,21588,19878,19945,.5237276,.49915877,,,0,1
2016,22,Louisiana,Asian,1154,942,2088,1703,1194,894,917,786,.57183909,.53846157,,,1,0
2016,22,Louisiana,Black,5036,4612,6742,6105,1110,5632,924,5181,.16463958,.15135135,,,1,0
2016,22,Louisiana,Hispanic,1643,1270,2406,1805,974,1432,599,1206,.40482128,.33185595,,,1,0
2016,22,Louisiana,Total,22679,17503,32565,24448,13198,19367,8356,16092,.40528175,.34178665,9891,3018,1,0
2016,22,Louisiana,White,13370,9426,19350,13186,9312,10038,5477,7709,.4812403,.41536477,,,1,0
2016,23,Maine,Asian,603,494,1320,1098,737,583,597,501,.55833334,.54371583,,,0,0
2016,23,Maine,Black,113,106,184,172,71,113,70,102,.38586956,.40697673,,,0,0
2016,23,Maine,Hispanic,215,191,370,325,194,176,176,149,.5243243,.54153848,,,0,0
2016,23,Maine,Total,8638,7974,15327,14107,9061,6266,8335,5772,.59117895,.59084141,4290,2692,0,0
2016,23,Maine,White,7334,6851,12852,11978,7727,5125,7203,4775,.60122937,.60135245,,,0,0
2016,24,Maryland,Asian,8132,7376,18927,17381,14010,4917,12932,4449,.74021238,.74403083,,,0,0
2016,24,Maryland,Black,11252,10219,17826,16211,6249,11577,5541,10670,.35055536,.34180495,,,0,0
2016,24,Maryland,Hispanic,6821,6195,11630,10559,6329,5301,5664,4895,.54419607,.53641444,,,0,0
2016,24,Maryland,Total,66098,57318,124479,108392,78008,46471,67277,41115,.62667596,.62068236,27691,17095,0,0
2016,24,Maryland,White,35057,29285,67521,56688,46294,21227,38654,18034,.68562371,.68187273,,,0,0
2016,25,Massachusetts,Asian,7394,5379,16246,11864,12495,3751,9016,2848,.76911241,.75994605,,,0,0
2016,25,Massachusetts,Black,3220,2720,5226,4363,1889,3337,1399,2964,.36146191,.32065094,,,0,0
2016,25,Massachusetts,Hispanic,6196,5369,10178,8778,4912,5266,3970,4808,.48260954,.45226702,,,0,0
2016,25,Massachusetts,Total,61887,50864,113869,92395,77880,35989,61393,31002,.68394381,.66446239,29007,20436,0,0
2016,25,Massachusetts,White,41890,34825,76485,62870,54661,21824,44058,18812,.71466303,.70077938,,,0,0
2016,26,Michigan,Asian,5293,4565,11232,9716,8469,2763,7294,2422,.75400639,.75072044,,,0,0
2016,26,Michigan,Black,3049,2632,4330,3713,1345,2985,1092,2621,.31062356,.2941018,,,0,0
2016,26,Michigan,Hispanic,3435,3027,5387,4744,2756,2631,2376,2368,.51160198,.50084317,,,0,0
2016,26,Michigan,Total,62601,55146,103427,90896,66012,37415,57310,33586,.63824725,.63050079,30428,19793,0,0
2016,26,Michigan,White,47262,41732,76831,67699,50061,26770,43613,24086,.65157294,.64421928,,,0,0
2016,27,Minnesota,Asian,3733,3221,6996,6020,4564,2432,3891,2129,.65237278,.6463455,,,0,0
2016,27,Minnesota,Black,1642,1474,2307,2049,945,1362,824,1225,.40962288,.40214738,,,0,0
2016,27,Minnesota,Hispanic,2326,2023,3579,3061,1886,1693,1568,1493,.52696282,.5122509,,,0,0
2016,27,Minnesota,Total,43780,38606,71136,62021,46866,24270,40684,21337,.65882254,.65597135,19096,12533,0,0
2016,27,Minnesota,White,33467,29569,54192,47352,37048,17144,32322,15030,.68364334,.68258995,,,0,0
2016,28,Mississippi,Asian,361,297,709,549,425,284,313,236,.59943581,.57012749,,,0,0
2016,28,Mississippi,Black,2504,2359,3599,3381,372,3227,327,3054,.10336205,.096716948,,,0,0
2016,28,Mississippi,Hispanic,426,383,664,600,206,458,178,422,.31024095,.29666665,,,0,0
2016,28,Mississippi,Total,9401,8023,14437,12219,4803,9634,3688,8531,.33268684,.30182502,4507,1501,0,0
2016,28,Mississippi,White,5597,4518,8717,7007,3609,5108,2711,4296,.41401857,.38689882,,,0,0
2016,29,Missouri,Asian,1572,1276,3477,2776,2647,830,2075,701,.76128846,.74747837,,,0,0
2016,29,Missouri,Black,2149,1880,3037,2618,790,2247,637,1981,.26012513,.2433155,,,0,0
2016,29,Missouri,Hispanic,1437,1192,2179,1776,1103,1076,843,933,.50619549,.47466215,,,0,0
2016,29,Missouri,Total,25610,20626,42080,33120,26908,15172,20374,12746,.63944864,.61515701,11704,6938,0,0
2016,29,Missouri,White,18805,14899,30818,23895,20946,9872,15761,8134,.67966771,.65959406,,,0,0
2016,30,Montana,Asian,51,44,96,86,65,31,57,29,.67708331,.66279072,,,0,0
2016,30,Montana,Black,11,11,15,15,10,5,10,5,.66666669,.66666669,,,0,0
2016,30,Montana,Hispanic,121,107,178,154,96,82,84,70,.53932583,.54545456,,,0,0
2016,30,Montana,Total,3193,2954,5024,4659,3233,1791,3018,1641,.64351118,.64777851,1905,1197,0,0
2016,30,Montana,White,2744,2547,4371,4064,2896,1475,2708,1356,.6625486,.66633856,,,0,0
2016,31,Nebraska,Asian,508,414,1083,900,719,364,587,313,.66389656,.65222222,,,0,0
2016,31,Nebraska,Black,231,218,353,334,124,229,117,217,.35127479,.35029939,,,0,0
2016,31,Nebraska,Hispanic,784,762,1251,1209,464,787,428,781,.37090328,.35401157,,,0,0
2016,31,Nebraska,Total,7648,6919,13135,11878,7682,5453,6753,5125,.58484966,.56853008,3559,2167,0,0
2016,31,Nebraska,White,5704,5137,9783,8821,6034,3749,5315,3506,.61678421,.60253942,,,0,0
2016,32,Nevada,Asian,2635,2429,5518,5039,3062,2456,2715,2324,.5549112,.53879738,,,0,0
2016,32,Nevada,Black,690,645,1157,1085,396,761,366,719,.34226447,.33732718,,,0,0
2016,32,Nevada,Hispanic,6440,6197,10999,10565,4139,6860,3905,6660,.37630695,.36961666,,,0,0
2016,32,Nevada,Total,19142,17800,34669,32047,17092,17577,15453,16594,.49300528,.48219803,9043,5201,0,0
2016,32,Nevada,White,7577,6821,13860,12389,7985,5875,7062,5327,.57611835,.57002181,,,0,0
2016,33,New Hampshire,Asian,746,388,1547,782,1191,356,587,195,.7698772,.75063938,,,0,0
2016,33,New Hampshire,Black,82,47,125,64,66,59,34,30,.528,.53125,,,0,0
2016,33,New Hampshire,Hispanic,300,227,436,315,292,144,206,109,.66972476,.65396827,,,0,0
2016,33,New Hampshire,Total,7565,5862,12456,9351,8862,3594,6551,2800,.71146435,.70056677,3675,2688,0,0
2016,33,New Hampshire,White,6037,4902,9709,7728,6847,2862,5401,2327,.70522195,.69888717,,,0,0
2016,34,New Jersey,Asian,14114,12369,32300,28631,25659,6641,22951,5680,.79439628,.80161363,,,0,0
2016,34,New Jersey,Black,4179,3341,6846,5409,2668,4178,2152,3257,.38971663,.39785543,,,0,0
2016,34,New Jersey,Hispanic,11755,9674,19509,15877,9963,9546,8462,7415,.51068735,.53297222,,,0,0
2016,34,New Jersey,Total,71380,59555,138332,115966,96493,41839,82181,33785,.69754648,.7086646,34445,24946,0,0
2016,34,New Jersey,White,37813,31275,72928,60487,53431,19497,44662,15825,.73265415,.73837352,,,0,0
2016,35,New Mexico,Asian,383,301,842,677,518,324,396,281,.61520189,.58493352,,,0,0
2016,35,New Mexico,Black,122,106,192,171,58,134,49,122,.30208334,.28654972,,,0,0
2016,35,New Mexico,Hispanic,6038,5415,8935,7982,2678,6257,2178,5804,.2997202,.27286395,,,0,0
2016,35,New Mexico,Total,10756,9188,16915,14436,6440,10475,5100,9336,.38072717,.35328346,5624,2339,0,0
2016,35,New Mexico,White,3183,2609,5386,4455,2800,2586,2185,2270,.51986635,.49046016,,,0,0
2016,36,New York,Asian,24436,21918,48590,43771,32850,15740,29750,14021,.67606503,.67967373,,,0,0
2016,36,New York,Black,13043,11018,19754,16788,6702,13052,5584,11204,.33927307,.33261853,,,0,0
2016,36,New York,Hispanic,27528,23531,43179,36967,21663,21516,18413,18554,.50170219,.49809289,,,0,0
2016,36,New York,Total,158280,135647,278524,239694,175168,103356,150551,89143,.62891531,.62809664,72241,47688,0,0
2016,36,New York,White,84677,71739,152676,129702,105098,47578,89135,40567,.68837279,.68722922,,,0,0
2016,37,North Carolina,Asian,5416,4855,12851,11532,8621,4230,7633,3899,.67084271,.6618973,,,0,1
2016,37,North Carolina,Black,8680,8373,14132,13542,3670,10462,3314,10228,.25969431,.24472013,,,0,1
2016,37,North Carolina,Hispanic,7473,7074,12988,12163,5475,7513,4894,7269,.42154297,.40236783,,,0,1
2016,37,North Carolina,Total,77465,70028,145001,129686,77737,67264,66713,62973,.53611356,.51441944,35752,19702,0,1
2016,37,North Carolina,White,50877,45057,96244,84377,55926,40318,47344,37033,.58108556,.56110078,,,0,1
2016,38,North Dakota,Asian,69,60,127,115,97,30,95,20,.76377952,.82608694,,,0,1
2016,38,North Dakota,Black,21,21,25,25,8,17,8,17,.31999999,.31999999,,,0,1
2016,38,North Dakota,Hispanic,58,47,82,69,48,34,41,28,.58536583,.59420288,,,0,1
2016,38,North Dakota,Total,1894,1593,2746,2338,1690,1056,1511,827,.61544067,.64627886,1094,681,0,1
2016,38,North Dakota,White,1664,1390,2383,2007,1464,919,1295,712,.61435163,.64524168,,,0,1
2016,39,Ohio,Asian,4387,2077,10464,5133,8197,2267,4126,1007,.78335243,.8038184,,,0,0
2016,39,Ohio,Black,4540,1653,6698,2508,2154,4544,875,1633,.32158855,.34888357,,,0,0
2016,39,Ohio,Hispanic,2860,1278,4722,2199,2732,1990,1317,882,.5785684,.5989086,,,0,0
2016,39,Ohio,Total,69263,31612,121044,57091,78704,42340,38812,18279,.65020984,.67982692,31066,19429,0,0
2016,39,Ohio,White,53543,24787,92754,44254,61980,30774,30683,13571,.66821915,.69333845,,,0,0
2016,40,Oklahoma,Asian,1304,1183,2965,2745,1645,1320,1490,1255,.55480605,.54280508,,,0,0
2016,40,Oklahoma,Black,1075,1032,1706,1644,378,1328,352,1292,.22157092,.21411192,,,0,0
2016,40,Oklahoma,Hispanic,2678,2566,4478,4292,1563,2915,1453,2839,.34903976,.3385368,,,0,0
2016,40,Oklahoma,Total,17895,16478,30850,28448,14487,16363,12840,15608,.46959481,.45134982,9135,4564,0,0
2016,40,Oklahoma,White,9768,8809,16688,15063,8844,7844,7672,7391,.52996165,.50932747,,,0,0
2016,41,Oregon,Asian,2178,1826,4186,3530,2766,1420,2295,1235,.66077399,.65014166,,,0,0
2016,41,Oregon,Black,258,218,357,309,135,222,110,199,.37815127,.35598704,,,0,0
2016,41,Oregon,Hispanic,2916,2741,4248,3983,1827,2421,1650,2333,.43008474,.4142606,,,0,0
2016,41,Oregon,Total,19839,17798,31867,28367,19217,12650,16592,11775,.6030376,.58490497,9604,6060,0,0
2016,41,Oregon,White,12789,11498,20388,18187,12887,7501,11196,6991,.63208753,.61560458,,,0,0
2016,42,Pennsylvania,Asian,7034,5574,15661,12539,11578,4083,9267,3272,.73928869,.73905414,,,0,0
2016,42,Pennsylvania,Black,4190,3388,6339,5109,1881,4458,1484,3625,.29673451,.2904678,,,0,0
2016,42,Pennsylvania,Hispanic,4385,3693,6986,5813,3662,3324,3029,2784,.52419126,.52107346,,,0,0
2016,42,Pennsylvania,Total,71795,59834,127676,105969,85451,42225,71501,34468,.66928005,.67473507,33698,22534,0,0
2016,42,Pennsylvania,White,52810,44305,92919,77668,64772,28147,54776,22892,.69708025,.70525825,,,0,0
2016,44,Rhode Island,Asian,492,261,1080,528,674,406,274,254,.6240741,.51893938,,,0,0
2016,44,Rhode Island,Black,323,286,504,442,127,377,97,345,.25198412,.21945702,,,0,0
2016,44,Rhode Island,Hispanic,1006,914,1658,1473,706,952,577,896,.42581424,.39171758,,,0,0
2016,44,Rhode Island,Total,6606,5039,11933,8656,7087,4846,4754,3902,.59389925,.54921442,2944,1726,0,0
2016,44,Rhode Island,White,4395,3286,8007,5718,5184,2823,3544,2174,.64743352,.61979711,,,0,0
2016,45,South Carolina,Asian,1365,1180,2705,2293,1866,839,1571,722,.68983364,.68512863,,,1,1
2016,45,South Carolina,Black,3772,3684,5272,5112,1581,3691,1505,3607,.2998862,.29440531,,,1,1
2016,45,South Carolina,Hispanic,2203,2101,3326,3152,1659,1667,1550,1602,.49879736,.49175128,,,1,1
2016,45,South Carolina,Total,30878,28455,49504,44992,28857,20647,25786,19206,.58292258,.57312411,13570,7911,1,1
2016,45,South Carolina,White,21704,19723,35411,31766,22270,13141,19758,12008,.62890065,.62198579,,,1,1
2016,46,South Dakota,Asian,86,78,165,155,110,55,103,52,.66666669,.66451615,,,0,0
2016,46,South Dakota,Black,53,53,88,88,43,45,43,45,.48863637,.48863637,,,0,0
2016,46,South Dakota,Hispanic,95,87,152,143,90,62,82,61,.59210527,.57342654,,,0,0
2016,46,South Dakota,Total,2643,2420,4210,3895,2859,1351,2637,1258,.67909741,.6770218,1473,997,0,0
2016,46,South Dakota,White,2260,2070,3589,3313,2500,1089,2300,1013,.69657284,.69423485,,,0,0
2016,47,Tennessee,Asian,2124,1674,4791,3749,3356,1435,2526,1223,.70048004,.67377967,,,0,1
2016,47,Tennessee,Black,3281,3020,4701,4275,1448,3253,1199,3076,.30801958,.28046784,,,0,1
2016,47,Tennessee,Hispanic,2228,1978,3463,2964,1701,1762,1348,1616,.49119261,.45479083,,,0,1
2016,47,Tennessee,Total,33654,27489,55907,44312,32600,23307,23871,20441,.58311123,.53870285,13511,7268,0,1
2016,47,Tennessee,White,24214,19274,40093,30954,24626,15467,17687,13267,.61422193,.57139629,,,0,1
2016,48,Texas,Asian,29436,27931,70896,67564,47317,23579,44846,22718,.66741425,.66375583,,,0,0
2016,48,Texas,Black,21040,20414,35991,34907,9166,26825,8604,26303,.25467479,.24648352,,,0,0
2016,48,Texas,Hispanic,131464,127423,229073,222138,74557,154516,70598,151540,.32547265,.31781146,,,0,0
2016,48,Texas,Total,289550,274161,542178,513204,250081,292097,230461,282743,.46125257,.44906315,122606,63963,0,0
2016,48,Texas,White,94153,85733,182169,166005,107497,74672,95858,70147,.59009492,.57744044,,,0,0
2016,49,Utah,Asian,1076,892,1976,1614,1311,665,1077,537,.66346157,.66728622,,,0,0
2016,49,Utah,Black,182,148,271,210,119,152,80,130,.43911439,.38095239,,,0,0
2016,49,Utah,Hispanic,2824,2576,4167,3753,2222,1945,1972,1781,.53323734,.5254463,,,0,0
2016,49,Utah,Total,26573,24355,41274,37563,27305,13969,24801,12762,.66155452,.66025078,12506,8613,0,0
2016,49,Utah,White,20875,19248,32388,29725,22202,10186,20349,9376,.6855008,.68457526,,,0,0
2016,50,Vermont,Asian,221,121,428,232,298,130,170,62,.6962617,.73275864,,,0,0
2016,50,Vermont,Black,53,33,100,57,47,53,29,28,.47,.50877196,,,0,0
2016,50,Vermont,Hispanic,89,76,153,127,101,52,86,41,.66013074,.67716533,,,0,0
2016,50,Vermont,Total,3732,3213,6448,5418,4221,2227,3525,1893,.6546216,.65060908,2211,1517,0,0
2016,50,Vermont,White,3213,2851,5513,4796,3639,1874,3127,1669,.6600762,.65200168,,,0,0
2016,51,Virginia,Asian,10353,9483,24914,22957,17551,7363,16196,6761,.70446336,.70549285,,,0,0
2016,51,Virginia,Black,7628,7150,12816,11951,4700,8116,4341,7610,.36672908,.36323321,,,0,0
2016,51,Virginia,Hispanic,8315,7743,15005,13874,8121,6884,7379,6495,.54121959,.53185815,,,0,0
2016,51,Virginia,Total,77962,70796,154578,140006,97691,56887,87761,52245,.63198513,.62683743,35222,23430,0,0
2016,51,Virginia,White,45524,40706,90386,80563,60536,29850,53576,26987,.66974974,.66501993,,,0,0
2016,53,Washington,Asian,7776,7124,15699,14440,10478,5221,9586,4854,.66743106,.66385043,,,0,0
2016,53,Washington,Black,1415,1325,2056,1910,650,1406,570,1340,.31614786,.29842931,,,0,0
2016,53,Washington,Hispanic,6566,6045,9955,9159,4129,5826,3688,5471,.41476646,.40266404,,,0,0
2016,53,Washington,Total,51255,46767,87068,79295,52429,34639,47124,32171,.60216153,.59428716,24603,14842,0,0
2016,53,Washington,White,29691,26867,49833,44964,31935,17898,28527,16437,.64084041,.6344409,,,0,0
2016,54,West Virginia,Asian,249,207,562,463,409,153,335,128,.72775799,.72354209,,,1,0
2016,54,West Virginia,Black,143,132,225,211,63,162,58,153,.28,.27488151,,,1,0
2016,54,West Virginia,Hispanic,222,204,381,355,189,192,184,171,.49606299,.51830983,,,1,0
2016,54,West Virginia,Total,8086,7589,13232,12383,5650,7582,5199,7184,.42699516,.41984978,4445,1904,1,0
2016,54,West Virginia,White,6974,6572,11278,10614,4643,6635,4297,6317,.41168648,.40484267,,,1,0
2016,55,Wisconsin,Asian,2237,1875,4340,3639,2942,1398,2412,1227,.67788017,.66281945,,,0,0
2016,55,Wisconsin,Black,1281,1128,1880,1644,498,1382,395,1249,.26489362,.24026763,,,0,0
2016,55,Wisconsin,Hispanic,3138,2756,4940,4333,2484,2456,2168,2165,.50283402,.50034618,,,0,0
2016,55,Wisconsin,Total,44210,40367,74560,68191,49148,25412,44717,23474,.65917385,.655761,21270,14883,0,0
2016,55,Wisconsin,White,35502,32733,60030,55498,41162,18868,37880,17618,.68569046,.68254709,,,0,0
2016,56,Wyoming,Asian,31,31,51,51,32,19,32,19,.627451,.627451,,,0,0
2016,56,Wyoming,Black,9,9,14,14,5,9,5,9,.35714287,.35714287,,,0,0
2016,56,Wyoming,Hispanic,209,207,279,277,128,151,126,151,.45878136,.45487365,,,0,0
2016,56,Wyoming,Total,1926,1900,2824,2779,1579,1245,1541,1238,.55913597,.55451602,1121,655,0,0
2016,56,Wyoming,White,1560,1538,2313,2272,1328,985,1294,978,.57414615,.56954223,,,0,0
2017,1,Alabama,Asian,1392,1208,3335,2915,2029,1306,1699,1216,.60839581,.58284736,,,0,0
2017,1,Alabama,Black,4637,4490,7733,7508,1371,6362,1301,6207,.17729212,.17328183,,,0,0
2017,1,Alabama,Hispanic,1799,1688,3250,3065,1080,2170,972,2093,.3323077,.31712887,,,0,0
2017,1,Alabama,Total,29427,26523,54656,49584,22514,32142,19366,30218,.41192183,.39056954,14419,6063,0,0
2017,1,Alabama,White,19717,17383,37002,32977,16860,20142,14338,18639,.45565104,.43478787,,,0,0
2017,2,Alaska,Asian,383,376,693,683,311,382,307,376,.44877344,.44948757,,,0,0
2017,2,Alaska,Black,65,64,107,105,44,63,42,63,.41121495,.40000001,,,0,0
2017,2,Alaska,Hispanic,334,327,516,508,296,220,293,215,.57364339,.57677168,,,0,0
2017,2,Alaska,Total,3456,3358,5876,5737,3510,2366,3426,2311,.59734511,.59717625,1929,1180,0,0
2017,2,Alaska,White,2109,2039,3621,3521,2336,1285,2275,1246,.64512563,.64612329,,,0,0
2017,4,Arizona,Asian,3534,3232,8621,7937,6417,2204,5884,2053,.74434519,.74133801,,,0,0
2017,4,Arizona,Black,1015,933,1732,1580,722,1010,645,935,.41685912,.40822786,,,0,0
2017,4,Arizona,Hispanic,14895,14012,23740,22230,9846,13894,8864,13366,.41474304,.39874044,,,0,0
2017,4,Arizona,Total,39784,36359,71216,64474,40514,30702,35767,28707,.56888902,.55475074,18738,10734,0,0
2017,4,Arizona,White,17444,15518,32093,28168,20783,11310,17977,10191,.6475867,.63820648,,,0,0
2017,5,Arkansas,Asian,938,878,2280,2176,1265,1015,1202,974,.55482459,.55238968,,,1,1
2017,5,Arkansas,Black,3685,3639,5935,5853,683,5252,630,5223,.11508004,.10763711,,,1,1
2017,5,Arkansas,Hispanic,3325,3275,5491,5416,1640,3851,1585,3831,.29867056,.29265141,,,1,1
2017,5,Arkansas,Total,27990,27180,48425,47187,16845,31580,16041,31146,.34785751,.33994532,13851,5215,1,1
2017,5,Arkansas,White,18007,17386,31301,30381,12081,19220,11485,18896,.3859621,.37803233,,,1,1
2017,6,California,Asian,94301,83933,206722,183377,141954,64768,124677,58700,.68669033,.67989445,,,0,0
2017,6,California,Black,10783,9649,18209,16229,6415,11794,5390,10839,.35229832,.33212152,,,0,0
2017,6,California,Hispanic,174347,163605,303256,283963,127273,175983,115981,167982,.41968831,.40843701,,,0,0
2017,6,California,Total,411620,368367,779608,693752,446833,332775,386998,306754,.57315087,.55783337,178849,119820,0,0
2017,6,California,White,103591,86318,198183,164151,137378,60805,112385,51766,.69318759,.68464404,,,0,0
2017,8,Colorado,Asian,3105,2888,6033,5591,4027,2006,3717,1874,.66749543,.66481847,,,0,0
2017,8,Colorado,Black,1603,1561,2420,2359,849,1571,818,1541,.35082644,.34675711,,,0,0
2017,8,Colorado,Hispanic,11359,10973,17535,16883,7564,9971,7108,9775,.43136585,.42101523,,,0,0
2017,8,Colorado,Total,51335,48363,86292,80855,51918,34374,47782,33073,.60165483,.59095913,22785,14572,0,0
2017,8,Colorado,White,31714,29559,54491,50536,36079,18412,32998,17538,.66210932,.65296024,,,0,0
2017,9,Connecticut,Asian,3808,2626,8618,5921,6685,1933,4441,1480,.775702,.7500422,,,0,0
2017,9,Connecticut,Black,1988,1747,3185,2768,1154,2031,880,1888,.3623234,.31791908,,,0,0
2017,9,Connecticut,Hispanic,4430,3915,7421,6444,4026,3395,3349,3095,.5425145,.51970828,,,0,0
2017,9,Connecticut,Total,35609,29042,66822,53248,47024,19798,36472,16776,.70372033,.68494594,15802,11434,0,0
2017,9,Connecticut,White,23552,19297,44115,35428,32722,11393,26001,9427,.74174315,.73391104,,,0,0
2017,10,Delaware,Asian,781,538,1858,1339,1281,577,915,424,.68945104,.68334579,,,0,0
2017,10,Delaware,Black,798,696,1242,1083,413,829,318,765,.33252817,.29362881,,,0,0
2017,10,Delaware,Hispanic,661,566,1060,916,473,587,377,539,.44622642,.41157204,,,0,0
2017,10,Delaware,Total,7152,5111,12797,9160,7537,5260,4907,4253,.58896619,.53569871,2861,1607,0,0
2017,10,Delaware,White,4456,2950,7865,5221,4915,2950,2985,2236,.62492055,.57172954,,,0,0
2017,11,District Of Columbia,Asian,291,136,659,294,432,227,132,162,.65553868,.44897959,,,1,1
2017,11,District Of Columbia,Black,2512,2229,3828,3339,765,3063,512,2827,.19984326,.15333933,,,1,1
2017,11,District Of Columbia,Hispanic,1251,962,2240,1663,965,1275,512,1151,.43080357,.30787733,,,1,1
2017,11,District Of Columbia,Total,6687,4235,12578,7224,6668,5910,2324,4900,.530132,.32170543,2198,646,1,1
2017,11,District Of Columbia,White,2104,581,4902,1395,3972,930,975,420,.81028152,.69892472,,,1,1
2017,12,Florida,Asian,13226,11144,29884,25077,18449,11435,14975,10102,.6173538,.59716076,,,0,1
2017,12,Florida,Black,22132,20941,35102,33066,10035,25067,9044,24022,.28588113,.27351359,,,0,1
2017,12,Florida,Hispanic,75154,64409,130454,109737,66263,64191,53568,56169,.50794148,.48814893,,,0,1
2017,12,Florida,Total,215446,187046,391250,335361,201799,189451,165746,169615,.51578021,.49423158,87868,49567,0,1
2017,12,Florida,White,91312,78297,172344,146618,96052,76292,78828,67790,.55732721,.53764206,,,0,1
2017,13,Georgia,Asian,10973,10052,25008,22948,17753,7255,16279,6669,.70989281,.70938647,,,0,0
2017,13,Georgia,Black,19461,18555,29342,27753,9251,20091,8469,19284,.31528184,.3051562,,,0,0
2017,13,Georgia,Hispanic,11844,11056,19642,18108,9522,10120,8539,9569,.48477751,.47155952,,,0,0
2017,13,Georgia,Total,99095,87538,175740,153136,103081,72659,87782,65354,.58655399,.57322901,40300,22219,0,0
2017,13,Georgia,White,50842,42444,91797,75360,61008,30789,49633,25727,.66459686,.65861201,,,0,0
2017,15,Hawaii,Asian,4055,2832,6589,4314,3668,2921,1901,2413,.55668539,.44065833,,,0,0
2017,15,Hawaii,Black,95,82,145,120,66,79,45,75,.45517242,.375,,,0,0
2017,15,Hawaii,Hispanic,1405,1046,2063,1488,891,1172,506,982,.43189529,.34005377,,,0,0
2017,15,Hawaii,Total,9657,6620,15227,9924,8111,7116,4192,5732,.53267223,.42241031,3664,1605,0,0
2017,15,Hawaii,White,1123,738,1842,1153,1195,647,625,528,.64875138,.54206419,,,0,0
2017,16,Idaho,Asian,336,311,801,760,505,296,476,284,.63046193,.62631577,,,0,1
2017,16,Idaho,Black,60,59,90,89,25,65,24,65,.27777779,.26966292,,,0,1
2017,16,Idaho,Hispanic,885,829,1405,1324,619,786,568,756,.4405694,.42900303,,,0,1
2017,16,Idaho,Total,7819,7353,13151,12475,7741,5410,7292,5183,.58862442,.58452904,4032,2490,0,1
2017,16,Idaho,White,6022,5670,10011,9504,6130,3881,5787,3717,.61232644,.6089015,,,0,1
2017,17,Illinois,Asian,13588,12664,30603,28687,22835,7768,21491,7196,.74616867,.74915469,,,0,0
2017,17,Illinois,Black,9356,8622,14610,13486,4341,10269,3891,9595,.29712525,.28852144,,,0,0
2017,17,Illinois,Hispanic,28391,26750,47982,45191,22158,25824,20530,24661,.46179816,.454294,,,0,0
2017,17,Illinois,Total,119855,109275,221267,202003,141383,79884,128346,73657,.63897014,.6353668,51653,34960,0,0
2017,17,Illinois,White,62446,55652,117185,104684,84984,32201,76014,28670,.72521228,.72612816,,,0,0
2017,18,Indiana,Asian,2712,2277,6254,5263,4358,1896,3610,1653,.69683403,.6859206,,,1,1
2017,18,Indiana,Black,2632,2403,3942,3589,1023,2919,885,2704,.25951293,.2465868,,,1,1
2017,18,Indiana,Hispanic,4342,4056,6935,6450,2757,4178,2491,3959,.39754868,.38620156,,,1,1
2017,18,Indiana,Total,50154,44979,84425,75145,44253,40172,38150,36995,.52416939,.50768512,24659,12544,1,1
2017,18,Indiana,White,37604,33666,62550,55623,33735,28815,29144,26479,.53932852,.52395594,,,1,1
2017,19,Iowa,Asian,863,805,1738,1640,1182,556,1109,531,.68009204,.67621952,,,0,0
2017,19,Iowa,Black,363,357,551,542,200,351,194,348,.3629764,.35793358,,,0,0
2017,19,Iowa,Hispanic,1017,980,1486,1438,689,797,663,775,.46366084,.46105704,,,0,0
2017,19,Iowa,Total,12981,12120,20372,19086,12732,7640,11853,7233,.62497544,.62103111,6837,4276,0,0
2017,19,Iowa,White,9946,9217,15383,14309,9983,5400,9241,5068,.64896315,.64581734,,,0,0
2017,20,Kansas,Asian,1069,976,2123,1961,1499,624,1391,570,.70607632,.70933199,,,0,0
2017,20,Kansas,Black,310,298,455,435,175,280,163,272,.38461539,.37471265,,,0,0
2017,20,Kansas,Hispanic,1278,1213,1888,1774,785,1103,712,1062,.41578391,.40135288,,,0,0
2017,20,Kansas,Total,10616,9694,17048,15571,10681,6367,9693,5878,.6265251,.6225034,5492,3304,0,0
2017,20,Kansas,White,7238,6528,11490,10381,7646,3844,6899,3482,.66544819,.66457951,,,0,0
2017,21,Kentucky,Asian,1462,1290,3117,2736,2069,1048,1784,952,.66377926,.6520468,,,0,1
2017,21,Kentucky,Black,1811,1751,2637,2534,727,1910,675,1859,.27569208,.26637727,,,0,1
2017,21,Kentucky,Hispanic,1811,1693,2831,2603,1244,1587,1079,1524,.4394207,.41452169,,,0,1
2017,21,Kentucky,Total,35750,32036,58063,51339,30285,27778,25596,25743,.52158862,.49856833,14828,7590,0,1
2017,21,Kentucky,White,28420,25205,46126,40345,24723,21403,20677,19668,.53598839,.51250464,,,0,1
2017,22,Louisiana,Asian,1205,1017,2212,1831,1276,936,1004,827,.57685351,.54833424,,,1,0
2017,22,Louisiana,Black,5496,5164,7481,6903,1215,6266,1017,5886,.16241144,.14732724,,,1,0
2017,22,Louisiana,Hispanic,1839,1468,2665,2065,1088,1577,729,1336,.40825516,.35302663,,,1,0
2017,22,Louisiana,Total,23737,19144,34717,27072,14401,20316,9466,17606,.41481119,.34966016,10007,3256,1,0
2017,22,Louisiana,White,13607,10071,20114,14325,10053,10061,6153,8172,.49980113,.4295288,,,1,0
2017,23,Maine,Asian,586,471,1294,1046,690,604,544,502,.5332303,.52007645,,,0,0
2017,23,Maine,Black,147,130,198,176,50,148,47,129,.25252524,.26704547,,,0,0
2017,23,Maine,Hispanic,221,196,368,326,202,166,177,149,.54891306,.54294479,,,0,0
2017,23,Maine,Total,8643,7962,15294,14011,8813,6481,8059,5952,.57623905,.5751909,3989,2535,0,0
2017,23,Maine,White,7281,6794,12748,11857,7487,5261,6965,4892,.58730781,.58741671,,,0,0
2017,24,Maryland,Asian,8840,8012,20364,18594,15142,5222,13865,4729,.74356705,.74567068,,,0,0
2017,24,Maryland,Black,11549,10410,18501,16659,6645,11856,5803,10856,.35916978,.34834024,,,0,0
2017,24,Maryland,Hispanic,7350,6643,12711,11422,7061,5650,6208,5214,.55550313,.54351252,,,0,0
2017,24,Maryland,Total,67737,58582,127262,110286,80986,46276,69585,40701,.63637221,.63095045,27387,17183,0,0
2017,24,Maryland,White,34751,28896,66233,55246,46233,20000,38510,16736,.69803572,.69706404,,,0,0
2017,25,Massachusetts,Asian,7932,5807,17129,12343,12915,4214,9175,3168,.75398445,.74333632,,,0,0
2017,25,Massachusetts,Black,3425,2950,5593,4790,1972,3621,1548,3242,.35258359,.32317328,,,0,0
2017,25,Massachusetts,Hispanic,6939,6064,11501,9948,5711,5790,4613,5335,.49656552,.46371129,,,0,0
2017,25,Massachusetts,Total,64822,53516,119658,97425,80918,38740,64137,33288,.67624396,.6583218,29511,20618,0,0
2017,25,Massachusetts,White,43044,35822,79118,65228,56070,23048,45492,19736,.70868826,.69743055,,,0,0
2017,26,Michigan,Asian,5626,4853,12138,10511,9303,2835,7976,2535,.76643598,.75882411,,,0,0
2017,26,Michigan,Black,3388,2975,4900,4300,1464,3436,1192,3108,.29877552,.27720931,,,0,0
2017,26,Michigan,Hispanic,3812,3356,5991,5283,3082,2909,2660,2623,.51443833,.50350177,,,0,0
2017,26,Michigan,Total,65067,57344,109164,96018,69828,39336,60692,35326,.63966143,.63208979,31252,20069,0,0
2017,26,Michigan,White,48649,42963,80316,70782,52443,27873,45797,24985,.65295833,.6470148,,,0,0
2017,27,Minnesota,Asian,4172,3533,7879,6650,5236,2643,4397,2253,.66455132,.66120303,,,0,0
2017,27,Minnesota,Black,1876,1709,2683,2430,1068,1615,961,1469,.39806187,.39547324,,,0,0
2017,27,Minnesota,Hispanic,2457,2073,3726,3057,2026,1700,1645,1412,.54374665,.53810924,,,0,0
2017,27,Minnesota,Total,45348,40073,73559,64324,48496,25063,42337,21987,.6592803,.65818357,19105,12660,0,0
2017,27,Minnesota,White,33972,30195,54853,48306,37344,17509,32876,15430,.68080139,.68057799,,,0,0
2017,28,Mississippi,Asian,403,345,849,726,488,361,396,330,.57479388,.54545456,,,0,0
2017,28,Mississippi,Black,2921,2763,4050,3841,448,3602,408,3433,.11061729,.10622234,,,0,0
2017,28,Mississippi,Hispanic,544,488,857,764,287,570,232,532,.33488914,.30366492,,,0,0
2017,28,Mississippi,Total,10580,9212,16068,13907,5574,10494,4417,9490,.34690067,.31760985,5246,1655,0,0
2017,28,Mississippi,White,6067,5023,9397,7743,4078,5319,3149,4594,.43396828,.40668991,,,0,0
2017,29,Missouri,Asian,1667,1357,3690,2994,2798,892,2238,756,.75826555,.747495,,,0,0
2017,29,Missouri,Black,2357,2027,3284,2785,839,2445,654,2131,.25548112,.23482944,,,0,0
2017,29,Missouri,Hispanic,1612,1348,2523,2014,1303,1220,968,1046,.51644868,.48063555,,,0,0
2017,29,Missouri,Total,26701,21631,44429,35008,28402,16027,21635,13373,.63926715,.61800158,11979,7216,0,0
2017,29,Missouri,White,19169,15271,31970,24762,21841,10129,16501,8261,.68317175,.66638398,,,0,0
2017,30,Montana,Asian,55,49,100,90,64,36,58,32,.63999999,.64444447,,,0,0
2017,30,Montana,Black,17,17,21,21,9,12,9,12,.42857143,.42857143,,,0,0
2017,30,Montana,Hispanic,157,144,237,217,121,116,112,105,.51054853,.51612902,,,0,0
2017,30,Montana,Total,3572,3340,5707,5322,3479,2228,3263,2059,.60960227,.61311537,1892,1205,0,0
2017,30,Montana,White,3020,2820,4870,4535,3040,1830,2846,1689,.62422997,.62756342,,,0,0
2017,31,Nebraska,Asian,549,451,1164,958,758,406,605,353,.65120274,.63152403,,,0,0
2017,31,Nebraska,Black,234,213,379,354,125,254,112,242,.3298153,.31638417,,,0,0
2017,31,Nebraska,Hispanic,1062,1016,1670,1598,656,1014,607,991,.39281437,.37984982,,,0,0
2017,31,Nebraska,Total,8469,7601,14196,12781,8209,5987,7224,5557,.57826149,.56521398,3803,2362,0,0
2017,31,Nebraska,White,6132,5470,10218,9170,6254,3964,5520,3650,.61205715,.60196292,,,0,0
2017,32,Nevada,Asian,3010,2794,6146,5652,3428,2718,3064,2588,.55776113,.54210901,,,0,0
2017,32,Nevada,Black,898,852,1489,1421,448,1041,424,997,.30087307,.29838142,,,0,0
2017,32,Nevada,Hispanic,7722,7430,13114,12598,4826,8288,4547,8051,.36800367,.36093029,,,0,0
2017,32,Nevada,Total,21880,20342,39185,36257,18878,20307,17049,19208,.48176599,.47022644,10007,5647,0,0
2017,32,Nevada,White,8154,7298,14711,13115,8409,6302,7409,5706,.57161307,.56492567,,,0,0
2017,33,New Hampshire,Asian,757,395,1496,745,1106,390,529,216,.73930484,.71006709,,,0,0
2017,33,New Hampshire,Black,101,56,163,94,80,83,49,45,.49079755,.52127659,,,0,0
2017,33,New Hampshire,Hispanic,311,233,516,373,339,177,230,143,.65697676,.61662197,,,0,0
2017,33,New Hampshire,Total,7576,5824,12560,9285,8663,3897,6359,2926,.68972927,.68486804,3656,2622,0,0
2017,33,New Hampshire,White,6045,4870,9795,7652,6712,3083,5262,2390,.6852476,.68766338,,,0,0
2017,34,New Jersey,Asian,15000,13146,34562,30506,27546,7016,24526,5980,.79700249,.80397296,,,0,0
2017,34,New Jersey,Black,4529,3583,7301,5763,2841,4460,2336,3427,.38912478,.40534443,,,0,0
2017,34,New Jersey,Hispanic,13435,11076,22435,18337,11056,11379,9483,8854,.49280143,.51715112,,,0,0
2017,34,New Jersey,Total,76216,63658,148041,124217,101999,46042,87220,36997,.68899155,.70215833,36093,26006,0,0
2017,34,New Jersey,White,39117,32391,75713,62838,54838,20875,45977,16861,.72428775,.73167509,,,0,0
2017,35,New Mexico,Asian,401,343,880,758,466,414,373,385,.52954543,.49208444,,,0,0
2017,35,New Mexico,Black,124,113,190,173,41,149,29,144,.21578947,.16763006,,,0,0
2017,35,New Mexico,Hispanic,6357,6062,9901,9419,2987,6914,2669,6750,.3016867,.2833634,,,0,0
2017,35,New Mexico,Total,11240,10319,18271,16735,6890,11381,6009,10726,.37710032,.35906783,6067,2447,0,0
2017,35,New Mexico,White,3209,2909,5543,5024,2944,2599,2554,2470,.53112036,.50835985,,,0,0
2017,36,New York,Asian,26144,23759,52353,47567,35889,16464,32779,14788,.68551946,.68911219,,,0,0
2017,36,New York,Black,14536,13039,22327,20081,7457,14870,6467,13614,.33399025,.32204571,,,0,0
2017,36,New York,Hispanic,30511,27394,47969,43095,23291,24678,20633,22462,.48554274,.47877944,,,0,0
2017,36,New York,Total,165666,144811,292527,255954,181809,110718,158268,97686,.62151188,.6183455,73499,47928,0,0
2017,36,New York,White,84928,72205,153487,130792,104987,48500,89506,41286,.68401235,.68433851,,,0,0
2017,37,North Carolina,Asian,5990,5376,14233,12815,9545,4688,8490,4325,.67062461,.66250485,,,0,1
2017,37,North Carolina,Black,9186,8833,14798,14163,3982,10816,3625,10538,.26909041,.2559486,,,0,1
2017,37,North Carolina,Hispanic,8460,8009,14804,13919,6047,8757,5460,8459,.40847069,.39226955,,,0,1
2017,37,North Carolina,Total,81957,74076,154529,138371,82728,71801,71393,66978,.53535581,.51595348,36288,19861,0,1
2017,37,North Carolina,White,52735,46671,100729,88328,58429,42300,49665,38663,.58006138,.56227922,,,0,1
2017,38,North Dakota,Asian,93,85,187,175,136,51,126,49,.72727275,.72000003,,,0,1
2017,38,North Dakota,Black,45,45,73,73,31,42,31,42,.42465752,.42465752,,,0,1
2017,38,North Dakota,Hispanic,81,70,115,101,49,66,43,58,.42608696,.42574257,,,0,1
2017,38,North Dakota,Total,2464,2197,3699,3349,2163,1536,1992,1357,.58475262,.59480441,1227,748,0,1
2017,38,North Dakota,White,2125,1887,3155,2843,1857,1298,1706,1137,.58858955,.60007036,,,0,1
2017,39,Ohio,Asian,4703,3837,11317,9379,8820,2497,7285,2094,.77935851,.77673525,,,0,0
2017,39,Ohio,Black,4755,4110,7113,6048,2250,4863,1864,4184,.31632224,.30820104,,,0,0
2017,39,Ohio,Hispanic,3055,2539,5074,4165,2936,2138,2343,1822,.57863617,.562545,,,0,0
2017,39,Ohio,Total,72328,59914,126876,104663,81781,45095,66917,37746,.64457422,.63935679,31469,19647,0,0
2017,39,Ohio,White,55644,45875,96292,79083,63619,32673,51976,27107,.66068834,.65723354,,,0,0
2017,40,Oklahoma,Asian,1318,1204,2962,2741,1652,1310,1497,1244,.55773127,.54615104,,,0,0
2017,40,Oklahoma,Black,1161,1126,1844,1792,402,1442,371,1421,.21800433,.20703125,,,0,0
2017,40,Oklahoma,Hispanic,2911,2808,4873,4692,1710,3163,1584,3108,.3509132,.33759591,,,0,0
2017,40,Oklahoma,Total,18375,17000,31816,29375,15276,16540,13575,15800,.48013577,.46212766,9281,4559,0,0
2017,40,Oklahoma,White,9764,8824,16853,15174,9281,7572,8092,7082,.55070317,.53328061,,,0,0
2017,41,Oregon,Asian,2377,1985,4646,3898,3086,1560,2537,1361,.66422731,.6508466,,,0,0
2017,41,Oregon,Black,297,254,419,365,151,268,123,242,.36038187,.3369863,,,0,0
2017,41,Oregon,Hispanic,3344,3158,4887,4577,2132,2755,1930,2647,.43625948,.4216736,,,0,0
2017,41,Oregon,Total,21052,18861,34131,30440,20346,13785,17720,12720,.59611499,.58212876,9885,6130,0,0
2017,41,Oregon,White,13068,11699,21093,18846,13187,7906,11582,7264,.6251837,.61456013,,,0,0
2017,42,Pennsylvania,Asian,7618,6016,16640,13296,12290,4350,9878,3418,.73858172,.74293023,,,0,0
2017,42,Pennsylvania,Black,4434,3576,6663,5363,1856,4807,1491,3872,.27855322,.27801603,,,0,0
2017,42,Pennsylvania,Hispanic,4886,4115,7885,6647,4070,3815,3415,3232,.51616997,.51376563,,,0,0
2017,42,Pennsylvania,Total,75952,63574,135748,113168,89902,45846,75611,37557,.66227126,.66813058,35367,23586,0,0
2017,42,Pennsylvania,White,55338,46719,98155,82417,67583,30572,57377,25040,.68853343,.69617921,,,0,0
2017,44,Rhode Island,Asian,491,240,1035,435,699,336,242,193,.67536235,.55632186,,,0,0
2017,44,Rhode Island,Black,363,318,571,491,168,403,112,379,.29422066,.2281059,,,0,0
2017,44,Rhode Island,Hispanic,1203,1107,1924,1751,751,1173,644,1107,.39033264,.36778983,,,0,0
2017,44,Rhode Island,Total,7141,5540,12684,9342,7424,5260,4952,4390,.58530432,.53007919,2876,1707,0,0
2017,44,Rhode Island,White,4652,3546,8418,6129,5403,3015,3696,2433,.64183891,.60303473,,,0,0
2017,45,South Carolina,Asian,1509,1323,3021,2608,2096,925,1789,819,.69380999,.68596625,,,1,1
2017,45,South Carolina,Black,3990,3904,5632,5472,1749,3883,1672,3800,.31054688,.30555555,,,1,1
2017,45,South Carolina,Hispanic,2678,2572,4062,3872,2054,2008,1918,1954,.50566226,.49535123,,,1,1
2017,45,South Carolina,Total,33334,30861,53625,48867,30961,22664,27630,21237,.57736129,.56541222,14339,8427,1,1
2017,45,South Carolina,White,23084,21088,37637,33810,23321,14316,20614,13196,.61962962,.60970128,,,1,1
2017,46,South Dakota,Asian,105,91,208,182,143,65,123,59,.6875,.67582417,,,0,0
2017,46,South Dakota,Black,71,70,116,115,47,69,46,69,.40517241,.40000001,,,0,0
2017,46,South Dakota,Hispanic,110,100,168,151,100,68,87,64,.59523809,.57615894,,,0,0
2017,46,South Dakota,Total,2884,2646,4688,4291,3261,1427,2992,1299,.69560581,.69727337,1419,964,0,0
2017,46,South Dakota,White,2425,2231,3957,3627,2826,1131,2602,1025,.71417743,.71739727,,,0,0
2017,47,Tennessee,Asian,2266,1827,5237,4229,3662,1575,2855,1374,.69925529,.67510051,,,0,1
2017,47,Tennessee,Black,3433,3159,5069,4623,1629,3440,1362,3261,.32136515,.2946139,,,0,1
2017,47,Tennessee,Hispanic,2562,2278,4095,3535,2025,2070,1607,1928,.49450549,.45459688,,,0,1
2017,47,Tennessee,Total,35527,29285,60301,48394,35693,24608,26632,21762,.59191388,.55031615,14155,7616,0,1
2017,47,Tennessee,White,25189,20221,42479,33115,26542,15937,19368,13747,.62482637,.58487087,,,0,1
2017,48,Texas,Asian,32756,31114,79775,76143,54041,25734,51371,24772,.67741776,.6746648,,,0,0
2017,48,Texas,Black,22162,21517,37938,36828,9642,28296,9113,27715,.25415152,.2474476,,,0,0
2017,48,Texas,Hispanic,142821,138288,249490,241377,81078,168412,76719,164658,.32497495,.31783891,,,0,0
2017,48,Texas,Total,310793,294544,584179,553008,270805,313374,250272,302736,.46356511,.4525649,130944,68338,0,0
2017,48,Texas,White,97933,89335,189783,173051,112627,77156,100741,72310,.59345144,.58214629,,,0,0
2017,49,Utah,Asian,1119,922,2094,1694,1348,746,1098,596,.64374405,.64816999,,,0,0
2017,49,Utah,Black,185,150,285,218,134,151,98,120,.47017545,.44954127,,,0,0
2017,49,Utah,Hispanic,3002,2764,4384,3990,2431,1953,2187,1803,.55451643,.54812032,,,0,0
2017,49,Utah,Total,27862,25508,43318,39223,29014,14304,26217,13006,.66979086,.66840887,13303,9197,0,0
2017,49,Utah,White,21908,20162,34048,31057,23543,10505,21438,9619,.69146502,.69027919,,,0,0
2017,50,Vermont,Asian,242,126,466,249,290,176,171,78,.62231761,.68674701,,,0,0
2017,50,Vermont,Black,53,35,86,54,46,40,29,25,.53488374,.53703701,,,0,0
2017,50,Vermont,Hispanic,135,114,249,204,158,91,127,77,.63453817,.622549,,,0,0
2017,50,Vermont,Total,3987,3386,6998,5828,4618,2380,3845,1983,.65990281,.65974605,2268,1576,0,0
2017,50,Vermont,White,3360,2947,5859,5050,3910,1949,3353,1697,.6673494,.6639604,,,0,0
2017,51,Virginia,Asian,11152,10175,27100,24917,19497,7603,17934,6983,.71944648,.71974957,,,0,0
2017,51,Virginia,Black,7404,6938,12472,11622,4779,7693,4408,7214,.38317832,.37928069,,,0,0
2017,51,Virginia,Hispanic,8767,8197,15735,14578,8569,7166,7820,6758,.54458213,.53642476,,,0,0
2017,51,Virginia,Total,79079,71870,157699,143084,101572,56127,91358,51726,.64408779,.63849205,35010,23510,0,0
2017,51,Virginia,White,45480,40764,90289,80801,61337,28952,54447,26354,.67934078,.67384064,,,0,0
2017,53,Washington,Asian,8357,7678,16839,15553,11535,5304,10595,4958,.68501693,.68121904,,,0,0
2017,53,Washington,Black,1530,1433,2223,2060,699,1524,612,1448,.31443995,.29708737,,,0,0
2017,53,Washington,Hispanic,7316,6780,10982,10128,4509,6473,4034,6094,.41058096,.39830175,,,0,0
2017,53,Washington,Total,53949,49365,91934,83869,55865,36069,50474,33395,.60766417,.60181952,25093,14867,0,0
2017,53,Washington,White,30452,27646,51421,46478,33096,18325,29755,16723,.64362806,.64019537,,,0,0
2017,54,West Virginia,Asian,244,205,570,473,380,190,316,157,.66666669,.6680761,,,1,0
2017,54,West Virginia,Black,157,150,239,230,80,159,75,155,.33472803,.32608697,,,1,0
2017,54,West Virginia,Hispanic,217,207,368,358,177,191,170,188,.48097825,.47486034,,,1,0
2017,54,West Virginia,Total,7976,7461,13125,12294,5741,7384,5323,6971,.43740952,.43297544,4475,1880,1,0
2017,54,West Virginia,White,6907,6480,11196,10534,4782,6414,4473,6061,.42711684,.42462501,,,1,0
2017,55,Wisconsin,Asian,2515,2120,5078,4261,3440,1638,2830,1431,.67743206,.66416335,,,0,0
2017,55,Wisconsin,Black,1362,1195,2042,1816,507,1535,422,1394,.24828599,.23237886,,,0,0
2017,55,Wisconsin,Hispanic,3495,3039,5553,4787,2810,2743,2383,2404,.50603276,.49780655,,,0,0
2017,55,Wisconsin,Total,46862,42685,79592,72492,52685,26907,47822,24670,.66193837,.65968657,21910,15310,0,0
2017,55,Wisconsin,White,37256,34319,63246,58333,43669,19577,40170,18163,.69046265,.68863249,,,0,0
2017,56,Wyoming,Asian,39,39,68,68,41,27,41,27,.60294116,.60294116,,,0,0
2017,56,Wyoming,Black,14,14,19,19,6,13,6,13,.31578946,.31578946,,,0,0
2017,56,Wyoming,Hispanic,207,203,285,275,138,147,129,146,.48421052,.46909091,,,0,0
2017,56,Wyoming,Total,1994,1962,3029,2972,1689,1340,1647,1325,.5576098,.55417228,1191,655,0,0
2017,56,Wyoming,White,1618,1591,2483,2437,1420,1063,1387,1050,.57188886,.5691424,,,0,0
2018,1,Alabama,Asian,1423,1253,3374,2986,2117,1257,1819,1167,.62744516,.60917616,,,0,0
2018,1,Alabama,Black,5185,5024,8523,8273,1460,7063,1355,6918,.17130119,.16378582,,,0,0
2018,1,Alabama,Hispanic,2016,1889,3716,3499,1193,2523,1060,2439,.32104415,.30294371,,,0,0
2018,1,Alabama,Total,30363,27609,57245,52431,22791,34454,19741,32690,.39813083,.3765139,15406,6388,0,0
2018,1,Alabama,White,19551,17380,37728,34011,16702,21026,14330,19681,.44269508,.42133427,,,0,0
2018,2,Alaska,Asian,434,429,758,752,360,398,359,393,.47493404,.47739363,,,0,0
2018,2,Alaska,Black,62,61,89,88,29,60,29,59,.32584271,.32954547,,,0,0
2018,2,Alaska,Hispanic,322,313,504,494,269,235,266,228,.53373015,.53846157,,,0,0
2018,2,Alaska,Total,3423,3328,5606,5483,3307,2299,3226,2257,.58990365,.58836401,1935,1211,0,0
2018,2,Alaska,White,2017,1960,3301,3228,2120,1181,2067,1161,.64222962,.64033455,,,0,0
2018,4,Arizona,Asian,3803,3413,9375,8546,7028,2347,6418,2128,.74965334,.75099462,,,0,0
2018,4,Arizona,Black,1040,965,1773,1628,731,1042,645,983,.41229555,.39619166,,,0,0
2018,4,Arizona,Hispanic,15206,14179,23993,22347,10116,13877,9089,13258,.42162296,.40672126,,,0,0
2018,4,Arizona,Total,40793,37104,72143,65440,41371,30772,36696,28744,.57345825,.56075794,20156,11392,0,0
2018,4,Arizona,White,17528,15595,31608,27996,20549,11059,17923,10073,.6501202,.64019859,,,0,0
2018,5,Arkansas,Asian,1023,955,2502,2351,1468,1034,1360,991,.5867306,.57847726,,,1,1
2018,5,Arkansas,Black,3441,3383,5691,5601,658,5033,625,4976,.11562116,.11158722,,,1,1
2018,5,Arkansas,Hispanic,3488,3427,5863,5761,1867,3996,1812,3949,.31843767,.31452873,,,1,1
2018,5,Arkansas,Total,27794,26767,48193,46563,17189,31004,16221,30342,.35667005,.34836674,14420,5395,1,1
2018,5,Arkansas,White,17582,16804,30482,29286,12057,18425,11335,17951,.39554492,.387045,,,1,1
2018,6,California,Asian,96946,86252,213631,188986,151100,62531,132387,56599,.70729434,.70051223,,,0,0
2018,6,California,Black,10839,9689,18230,16233,6548,11682,5461,10772,.35918814,.33641347,,,0,0
2018,6,California,Hispanic,178149,167204,306573,286738,133601,172972,122012,164726,.43578854,.42551738,,,0,0
2018,6,California,Total,421141,377158,794126,705680,468859,325267,406225,299455,.5904088,.57565045,191215,127351,0,0
2018,6,California,White,102193,85253,194678,161077,137581,57097,112522,48555,.70671058,.6985603,,,0,0
2018,8,Colorado,Asian,3330,3111,6540,6090,4476,2064,4132,1958,.68440366,.67848933,,,0,0
2018,8,Colorado,Black,1608,1551,2421,2328,895,1526,839,1489,.36968195,.36039519,,,0,0
2018,8,Colorado,Hispanic,11693,11315,18245,17580,8193,10052,7726,9854,.44905454,.43947667,,,0,0
2018,8,Colorado,Total,53220,50208,89675,84023,54838,34837,50638,33385,.6115194,.60266834,24463,15519,0,0
2018,8,Colorado,White,32823,30643,56169,52072,37464,18705,34388,17684,.66698712,.6603933,,,0,0
2018,9,Connecticut,Asian,4083,2828,9360,6384,7195,2165,4781,1603,.76869661,.74890351,,,0,0
2018,9,Connecticut,Black,2139,1905,3560,3149,1254,2306,976,2173,.35224718,.30993965,,,0,0
2018,9,Connecticut,Hispanic,4874,4358,8103,7109,4345,3758,3647,3462,.53622115,.51301169,,,0,0
2018,9,Connecticut,Total,37105,30414,69640,55744,48309,21331,37804,17940,.69369614,.67817163,16368,11689,0,0
2018,9,Connecticut,White,23693,19470,44387,35771,32637,11750,26213,9558,.73528284,.7328003,,,0,0
2018,10,Delaware,Asian,784,553,1922,1408,1439,483,1046,362,.74869925,.74289775,,,0,0
2018,10,Delaware,Black,830,722,1315,1138,457,858,351,787,.34752852,.30843586,,,0,0
2018,10,Delaware,Hispanic,733,636,1164,998,510,654,392,606,.43814433,.39278558,,,0,0
2018,10,Delaware,Total,7416,5288,13307,9442,7941,5366,5117,4325,.5967536,.54194027,2947,1645,0,0
2018,10,Delaware,White,4506,2956,7963,5203,4998,2965,2982,2221,.62765288,.57313091,,,0,0
2018,11,District Of Columbia,Asian,284,135,625,290,425,200,141,149,.68000001,.48620689,,,1,1
2018,11,District Of Columbia,Black,2319,2058,3574,3098,824,2750,573,2525,.230554,.18495804,,,1,1
2018,11,District Of Columbia,Hispanic,1117,854,1960,1422,941,1019,514,908,.48010203,.36146274,,,1,1
2018,11,District Of Columbia,Total,6574,4289,12302,7294,6738,5564,2685,4609,.54771584,.36811078,2257,773,1,1
2018,11,District Of Columbia,White,2069,658,4811,1585,3922,889,1175,410,.81521511,.7413249,,,1,1
2018,12,Florida,Asian,14061,11886,32150,26965,20488,11662,16642,10323,.63726282,.61717039,,,0,1
2018,12,Florida,Black,22438,21153,35579,33440,10273,25306,9315,24125,.28873774,.27855861,,,0,1
2018,12,Florida,Hispanic,78428,67092,136143,114276,71473,64670,57847,56429,.52498478,.50620431,,,0,1
2018,12,Florida,Total,219770,190304,398873,340785,209678,189195,172011,168774,.52567607,.50474936,91959,52189,0,1
2018,12,Florida,White,89696,76663,168975,143217,95114,73861,77832,65385,.56288803,.54345506,,,0,1
2018,13,Georgia,Asian,11709,10761,27156,24877,19892,7264,18245,6632,.73250848,.73340839,,,0,1
2018,13,Georgia,Black,18326,17386,28035,26291,9673,18362,8788,17503,.34503299,.33425888,,,0,1
2018,13,Georgia,Hispanic,12467,11469,20981,19076,10688,10293,9631,9445,.5094133,.50487524,,,0,1
2018,13,Georgia,Total,99169,87119,178201,154588,107494,70707,92082,62506,.60321772,.59566075,41091,23082,0,1
2018,13,Georgia,White,50242,41703,91135,74616,60981,30154,49918,24698,.66912824,.6689986,,,0,1
2018,15,Hawaii,Asian,4145,2962,6899,4569,3908,2991,2117,2452,.56645888,.4633399,,,0,0
2018,15,Hawaii,Black,95,85,140,124,50,90,37,87,.35714287,.29838711,,,0,0
2018,15,Hawaii,Hispanic,1464,1134,2163,1596,918,1245,556,1040,.42441055,.34837094,,,0,0
2018,15,Hawaii,Total,9903,7003,15829,10487,8478,7351,4557,5930,.53559923,.43453801,4141,1908,0,0
2018,15,Hawaii,White,1064,726,1815,1189,1158,657,654,535,.63801652,.55004203,,,0,0
2018,16,Idaho,Asian,312,293,773,734,500,273,472,262,.64683056,.64305174,,,0,1
2018,16,Idaho,Black,66,63,102,98,31,71,30,68,.30392158,.30612245,,,0,1
2018,16,Idaho,Hispanic,1034,957,1655,1540,658,997,603,937,.39758307,.39155844,,,0,1
2018,16,Idaho,Total,8158,7628,14038,13205,8267,5771,7763,5442,.58890158,.58788335,4490,2664,0,1
2018,16,Idaho,White,6209,5804,10626,10008,6597,4029,6214,3794,.62083566,.62090325,,,0,1
2018,17,Illinois,Asian,14697,13632,32943,30798,24625,8318,23114,7684,.74750328,.7505033,,,0,0
2018,17,Illinois,Black,9536,8745,15022,13754,4668,10354,4228,9526,.31074426,.30740148,,,0,0
2018,17,Illinois,Hispanic,31258,29236,52625,49213,25157,27468,23236,25977,.47804275,.47215167,,,0,0
2018,17,Illinois,Total,125609,114374,231728,211465,149284,82444,135798,75667,.64422083,.64217716,55228,36952,0,0
2018,17,Illinois,White,62851,56100,118039,105636,86385,31654,77450,28186,.73183441,.73317808,,,0,0
2018,18,Indiana,Asian,2789,2346,6471,5406,4486,1985,3680,1726,.69324678,.6807251,,,1,1
2018,18,Indiana,Black,2698,2444,4126,3729,1112,3014,971,2758,.26951042,.26039153,,,1,1
2018,18,Indiana,Hispanic,4747,4450,7777,7246,3082,4695,2781,4465,.39629677,.38379794,,,1,1
2018,18,Indiana,Total,51814,46368,88225,78309,45944,42281,39655,38654,.5207594,.50639135,25892,13403,1,1
2018,18,Indiana,White,38480,34345,64738,57373,34715,30023,30027,27346,.53623837,.52336466,,,1,1
2018,19,Iowa,Asian,933,883,1883,1788,1227,656,1160,628,.65161973,.64876956,,,0,0
2018,19,Iowa,Black,409,404,585,580,180,405,178,402,.30769232,.30689654,,,0,0
2018,19,Iowa,Hispanic,1199,1160,1815,1764,844,971,817,947,.46501377,.46315193,,,0,0
2018,19,Iowa,Total,13591,12826,20986,19847,13016,7970,12248,7599,.62022299,.61712098,7283,4542,0,0
2018,19,Iowa,White,10251,9615,15491,14554,10065,5426,9426,5128,.64973211,.64765698,,,0,0
2018,20,Kansas,Asian,1085,995,2147,1982,1565,582,1451,531,.7289241,.7320888,,,0,0
2018,20,Kansas,Black,269,259,392,374,176,216,161,213,.44897959,.43048128,,,0,0
2018,20,Kansas,Hispanic,994,924,1448,1346,747,701,679,667,.51588398,.50445765,,,0,0
2018,20,Kansas,Total,10112,9187,16314,14788,10651,5663,9595,5193,.65287483,.64883691,5833,3517,0,0
2018,20,Kansas,White,7064,6362,11268,10109,7521,3747,6722,3387,.66746539,.66495204,,,0,0
2018,21,Kentucky,Asian,1648,1446,3522,3089,2363,1159,2050,1039,.67092562,.66364521,,,0,1
2018,21,Kentucky,Black,1836,1783,2676,2583,768,1908,715,1868,.28699553,.2768099,,,0,1
2018,21,Kentucky,Hispanic,1898,1775,2987,2734,1317,1670,1154,1580,.44091061,.42209217,,,0,1
2018,21,Kentucky,Total,35094,31498,57408,50550,29986,27422,25251,25299,.52233136,.49952522,15627,7851,0,1
2018,21,Kentucky,White,27426,24384,44801,39029,24016,20785,20008,19021,.53605944,.51264447,,,0,1
2018,22,Louisiana,Asian,1288,1112,2429,2074,1473,956,1240,834,.60642242,.59787852,,,1,0
2018,22,Louisiana,Black,5334,4996,6981,6467,1394,5587,1187,5280,.19968486,.18354724,,,1,0
2018,22,Louisiana,Hispanic,1933,1610,2780,2258,1169,1611,852,1406,.42050359,.37732506,,,1,0
2018,22,Louisiana,Total,24230,19826,35675,28164,15748,19927,10925,17239,.44142959,.38790655,11476,3645,1,0
2018,22,Louisiana,White,13889,10496,21056,15238,10890,10166,7021,8217,.51719224,.460756,,,1,0
2018,23,Maine,Asian,668,212,1437,410,786,651,242,168,.54697287,.59024388,,,0,0
2018,23,Maine,Black,136,111,206,158,70,136,54,104,.33980581,.34177214,,,0,0
2018,23,Maine,Hispanic,243,174,427,300,231,196,159,141,.54098362,.52999997,,,0,0
2018,23,Maine,Total,8472,6603,15021,11385,8518,6503,6441,4944,.56707275,.5657444,4037,2469,0,0
2018,23,Maine,White,6944,5735,12106,9876,6980,5126,5643,4233,.57657361,.5713852,,,0,0
2018,24,Maryland,Asian,9309,8412,21400,19383,15948,5452,14528,4855,.74523365,.74952281,,,0,0
2018,24,Maryland,Black,10431,9238,16626,14694,6917,9709,6056,8638,.41603512,.412141,,,0,0
2018,24,Maryland,Hispanic,7611,6849,13139,11762,7390,5749,6479,5283,.56244767,.55084169,,,0,0
2018,24,Maryland,Total,67535,58137,127155,109563,83498,43657,71733,37830,.65666312,.65471917,27870,17960,0,0
2018,24,Maryland,White,34218,28344,65043,54000,45960,19083,38209,15791,.70660949,.70757407,,,0,0
2018,25,Massachusetts,Asian,8403,6346,18632,13879,14203,4429,10502,3377,.76229066,.75668275,,,0,0
2018,25,Massachusetts,Black,3535,3121,5888,5152,2224,3664,1763,3389,.37771741,.34219721,,,0,0
2018,25,Massachusetts,Hispanic,7416,6579,12319,10827,6258,6061,5250,5577,.50799578,.48489887,,,0,0
2018,25,Massachusetts,Total,66467,55579,124064,102241,83846,40218,67454,34787,.67582858,.65975487,30744,21350,0,0
2018,25,Massachusetts,White,42767,35961,79524,66153,55886,23638,45837,20316,.7027564,.69289374,,,0,0
2018,26,Michigan,Asian,5962,5133,12832,11065,9771,3061,8347,2718,.76145571,.75436062,,,0,0
2018,26,Michigan,Black,3431,2990,4985,4319,1579,3406,1254,3065,.31675026,.29034498,,,0,0
2018,26,Michigan,Hispanic,4030,3548,6417,5609,3394,3023,2924,2685,.5289076,.52130502,,,0,0
2018,26,Michigan,Total,66130,58389,110345,96966,70781,39564,61760,35206,.64145184,.63692427,32575,21004,0,0
2018,26,Michigan,White,48863,43294,79825,70386,52175,27650,45824,24562,.65361726,.65103859,,,0,0
2018,27,Minnesota,Asian,4368,3731,8324,7035,5575,2749,4697,2338,.66975009,.66766167,,,0,0
2018,27,Minnesota,Black,2079,1907,2969,2724,1228,1741,1108,1616,.41360727,.40675476,,,0,0
2018,27,Minnesota,Hispanic,2858,2464,4325,3613,2189,2136,1791,1822,.50612718,.49570993,,,0,0
2018,27,Minnesota,Total,45958,40770,75185,66066,49903,25282,43784,22282,.6637361,.66273123,20033,13295,0,0
2018,27,Minnesota,White,33300,29678,54374,48149,37573,16801,33301,14848,.69101042,.69162393,,,0,0
2018,28,Mississippi,Asian,409,350,810,668,466,344,361,307,.57530862,.54041916,,,0,0
2018,28,Mississippi,Black,2957,2858,4177,4027,508,3669,452,3575,.12161839,.11224236,,,0,0
2018,28,Mississippi,Hispanic,545,506,838,773,277,561,251,522,.33054891,.32470894,,,0,0
2018,28,Mississippi,Total,10712,9430,16087,13967,5665,10422,4477,9490,.3521477,.32054126,5907,1765,0,0
2018,28,Mississippi,White,6088,5063,9251,7587,4084,5167,3148,4439,.4414658,.41492027,,,0,0
2018,29,Missouri,Asian,1846,1485,4081,3290,3125,956,2498,792,.76574367,.75927049,,,0,0
2018,29,Missouri,Black,2566,2217,3716,3154,931,2785,716,2438,.2505382,.22701332,,,0,0
2018,29,Missouri,Hispanic,1792,1533,2746,2273,1418,1328,1091,1182,.51638746,.47998241,,,0,0
2018,29,Missouri,Total,27630,22620,45896,36671,28949,16947,22358,14313,.63075215,.60969156,12675,7399,0,0
2018,29,Missouri,White,19373,15623,32159,25295,21719,10440,16642,8653,.67536306,.65791661,,,0,0
2018,30,Montana,Asian,57,50,102,92,70,32,63,29,.68627453,.68478262,,,0,0
2018,30,Montana,Black,12,11,23,22,16,7,16,6,.69565219,.72727275,,,0,0
2018,30,Montana,Hispanic,177,161,257,233,146,111,134,99,.56809336,.57510728,,,0,0
2018,30,Montana,Total,3500,3290,5599,5271,3532,2067,3333,1938,.63082695,.63232785,1959,1170,0,0
2018,30,Montana,White,2962,2790,4814,4540,3113,1701,2944,1596,.64665556,.64845812,,,0,0
2018,31,Nebraska,Asian,654,544,1339,1103,882,457,717,386,.65870053,.65004534,,,0,0
2018,31,Nebraska,Black,262,236,412,376,152,260,127,249,.36893204,.33776596,,,0,0
2018,31,Nebraska,Hispanic,1201,1148,1920,1832,722,1198,671,1161,.37604168,.36626637,,,0,0
2018,31,Nebraska,Total,8888,7933,15240,13630,8587,6653,7558,6072,.56345147,.55451208,4120,2470,0,0
2018,31,Nebraska,White,6257,5532,10709,9530,6388,4321,5647,3883,.59650761,.59254986,,,0,0
2018,32,Nevada,Asian,3005,2783,6250,5689,3584,2666,3191,2498,.57344002,.56090701,,,0,0
2018,32,Nevada,Black,822,781,1341,1266,447,894,401,865,.33333334,.31674567,,,0,0
2018,32,Nevada,Hispanic,7713,7403,13112,12492,5132,7980,4767,7725,.39139721,.38160422,,,0,0
2018,32,Nevada,Total,21780,20157,39112,35682,19603,19509,17404,18278,.50120169,.48775291,10475,5862,0,0
2018,32,Nevada,White,7994,7107,14478,12624,8500,5978,7313,5311,.58709764,.57929343,,,0,0
2018,33,New Hampshire,Asian,781,448,1620,896,1236,384,662,234,.76296294,.73883927,,,0,0
2018,33,New Hampshire,Black,93,46,144,65,69,75,30,35,.47916666,.46153846,,,0,0
2018,33,New Hampshire,Hispanic,300,217,474,319,300,174,193,126,.63291138,.6050157,,,0,0
2018,33,New Hampshire,Total,7681,6043,12800,9612,8772,4028,6626,2986,.68531251,.68934667,3785,2683,0,0
2018,33,New Hampshire,White,5912,4864,9640,7645,6532,3108,5281,2364,.67759335,.69077832,,,0,0
2018,34,New Jersey,Asian,16156,14159,37508,33023,29700,7808,26301,6722,.79183108,.79644489,,,0,0
2018,34,New Jersey,Black,4620,3794,7521,6173,3013,4508,2470,3703,.40061161,.40012959,,,0,0
2018,34,New Jersey,Hispanic,14364,12440,23961,20800,12456,11505,10928,9872,.51984477,.5253846,,,0,0
2018,34,New Jersey,Total,79033,66918,154215,130866,106803,47412,91496,39370,.69255906,.69915789,37773,27303,0,0
2018,34,New Jersey,White,38723,32143,75293,62403,54465,20828,45634,16769,.72337401,.73127896,,,0,0
2018,35,New Mexico,Asian,377,328,812,709,466,346,376,333,.57389164,.5303244,,,0,0
2018,35,New Mexico,Black,116,102,174,148,63,111,41,107,.36206895,.27702704,,,0,0
2018,35,New Mexico,Hispanic,6146,5918,9474,9078,2990,6484,2734,6344,.3156006,.30116767,,,0,0
2018,35,New Mexico,Total,10612,10000,17292,16173,6808,10484,5995,10178,.39370808,.37067953,6321,2655,0,0
2018,35,New Mexico,White,3018,2755,5382,4890,2822,2560,2430,2460,.52434039,.49693251,,,0,0
2018,36,New York,Asian,27557,25207,55919,51050,39135,16784,35873,15177,.69985157,.70270324,,,0,0
2018,36,New York,Black,15865,14481,25051,22902,8290,16761,7323,15579,.3309249,.31975374,,,0,0
2018,36,New York,Hispanic,34581,31153,55226,49685,26771,28455,23628,26057,.48475355,.47555602,,,0,0
2018,36,New York,Total,173644,152566,309055,271455,191312,117743,167314,104141,.61902249,.61636001,79887,51260,0,0
2018,36,New York,White,83744,71160,153069,130294,105200,47869,90041,40253,.68727177,.69106025,,,0,0
2018,37,North Carolina,Asian,6348,5738,15581,14076,10868,4713,9683,4393,.6975162,.68790847,,,0,1
2018,37,North Carolina,Black,8743,8382,14041,13369,4169,9872,3783,9586,.29691619,.28296807,,,0,1
2018,37,North Carolina,Hispanic,9011,8528,15343,14389,6624,8719,5958,8431,.43172783,.41406631,,,0,1
2018,37,North Carolina,Total,83378,75467,157532,141038,87086,70446,75225,65813,.55281466,.53336692,38451,21323,0,1
2018,37,North Carolina,White,52996,46995,101410,88987,59812,41598,50857,38130,.58980376,.57151043,,,0,1
2018,38,North Dakota,Asian,104,93,222,207,146,76,138,69,.65765768,.66666669,,,0,1
2018,38,North Dakota,Black,77,73,130,124,59,71,58,66,.45384616,.46774194,,,0,1
2018,38,North Dakota,Hispanic,95,88,133,123,65,68,62,61,.48872182,.50406504,,,0,1
2018,38,North Dakota,Total,2937,2590,4595,4096,2576,2019,2304,1792,.56060934,.5625,1474,843,0,1
2018,38,North Dakota,White,2489,2178,3845,3394,2165,1680,1914,1480,.56306893,.56393635,,,0,1
2018,39,Ohio,Asian,4994,4045,11920,9826,9321,2599,7675,2151,.78196311,.78109097,,,0,0
2018,39,Ohio,Black,5041,4346,7498,6355,2410,5088,2008,4347,.32141903,.31597167,,,0,0
2018,39,Ohio,Hispanic,3432,2898,5698,4770,3276,2422,2673,2097,.5749386,.56037736,,,0,0
2018,39,Ohio,Total,73282,60847,129177,107047,83662,45515,68769,38278,.647654,.64241874,33584,20496,0,0
2018,39,Ohio,White,55123,45515,96048,79226,63938,32110,52419,26807,.66568798,.66163886,,,0,0
2018,40,Oklahoma,Asian,1388,1277,3147,2918,1689,1458,1521,1397,.53670162,.52124745,,,0,0
2018,40,Oklahoma,Black,1128,1091,1805,1726,368,1437,325,1401,.20387812,.18829665,,,0,0
2018,40,Oklahoma,Hispanic,3278,3172,5345,5171,1664,3681,1552,3619,.31131899,.30013537,,,0,0
2018,40,Oklahoma,Total,19224,17799,33222,30754,15016,18206,13268,17486,.45198965,.43142354,9882,4811,0,0
2018,40,Oklahoma,White,9903,8909,17237,15561,9096,8141,7881,7680,.52770203,.50645846,,,0,0
2018,41,Oregon,Asian,2299,1926,4566,3881,3110,1456,2575,1306,.68112135,.66348881,,,0,0
2018,41,Oregon,Black,277,228,419,341,150,269,118,223,.35799521,.34604105,,,0,0
2018,41,Oregon,Hispanic,3605,3439,5370,5105,2243,3127,2073,3032,.41769087,.40607247,,,0,0
2018,41,Oregon,Total,21121,19107,34989,31626,20916,14073,18389,13237,.59778786,.58145195,10483,6364,0,0
2018,41,Oregon,White,12730,11487,21049,19018,13286,7763,11733,7285,.63119388,.61694187,,,0,0
2018,42,Pennsylvania,Asian,7974,6326,17783,14295,13345,4438,10816,3479,.75043583,.75662822,,,0,0
2018,42,Pennsylvania,Black,4027,3380,6048,5064,1918,4130,1591,3473,.31712964,.31417853,,,0,0
2018,42,Pennsylvania,Hispanic,5335,4561,8714,7442,4758,3956,4079,3363,.54601789,.54810536,,,0,0
2018,42,Pennsylvania,Total,77232,65186,139358,117345,93182,46176,79051,38294,.66865194,.67366314,37116,24462,0,0
2018,42,Pennsylvania,White,55542,47171,99255,84029,68362,30893,58438,25591,.68875122,.69545037,,,0,0
2018,44,Rhode Island,Asian,574,326,1205,637,747,458,343,294,.61991704,.53846157,,,0,0
2018,44,Rhode Island,Black,382,348,649,573,156,493,105,468,.2403698,.18324608,,,0,0
2018,44,Rhode Island,Hispanic,1377,1270,2269,2044,780,1489,639,1405,.34376377,.31262231,,,0,0
2018,44,Rhode Island,Total,7878,6324,14342,11064,7962,6380,5680,5384,.55515271,.51337671,3429,1911,0,0
2018,44,Rhode Island,White,5027,3976,9318,7131,5815,3503,4291,2840,.62406093,.60173887,,,0,0
2018,45,South Carolina,Asian,1683,1503,3366,2947,2422,944,2106,841,.7195484,.71462506,,,1,1
2018,45,South Carolina,Black,4212,4115,5904,5722,1885,4019,1806,3916,.31927508,.31562391,,,1,1
2018,45,South Carolina,Hispanic,3063,2937,4753,4514,2477,2276,2307,2207,.52114457,.51107663,,,1,1
2018,45,South Carolina,Total,35286,32639,57332,52111,33979,23353,30423,21688,.59267074,.58381146,15175,8773,1,1
2018,45,South Carolina,White,23955,21846,39551,35397,25126,14425,22284,13113,.63528103,.62954485,,,1,1
2018,46,South Dakota,Asian,116,98,246,218,171,75,153,65,.69512194,.70183486,,,0,0
2018,46,South Dakota,Black,68,65,128,125,56,72,56,69,.4375,.44800001,,,0,0
2018,46,South Dakota,Hispanic,134,125,222,207,117,105,106,101,.52702701,.51207727,,,0,0
2018,46,South Dakota,Total,2861,2606,4771,4385,3210,1561,2975,1410,.67281491,.67844927,1520,1070,0,0
2018,46,South Dakota,White,2356,2164,3871,3583,2701,1170,2512,1071,.69775254,.70108849,,,0,0
2018,47,Tennessee,Asian,2495,2014,5820,4713,4040,1780,3137,1576,.69415808,.66560578,,,0,1
2018,47,Tennessee,Black,4229,3935,6467,5959,1793,4674,1499,4460,.27725375,.25155228,,,0,1
2018,47,Tennessee,Hispanic,3254,2944,5286,4713,2293,2993,1903,2810,.43378738,.40377679,,,0,1
2018,47,Tennessee,Total,38742,32300,66389,53957,37490,28899,28147,25810,.56470197,.52165616,15570,8220,0,1
2018,47,Tennessee,White,26270,21316,44734,35233,27298,17436,20068,15165,.61022937,.56957966,,,0,1
2018,48,Texas,Asian,35216,33503,85950,82085,60063,25887,57186,24899,.69881326,.69666809,,,0,0
2018,48,Texas,Black,21744,21144,36443,35396,10173,26270,9611,25785,.27914825,.27152786,,,0,0
2018,48,Texas,Hispanic,147433,143409,255183,247813,87614,167569,83457,164356,.34333792,.33677411,,,0,0
2018,48,Texas,Total,318150,302468,594643,564285,286847,307796,266464,297821,.48238522,.47221529,139506,72171,0,0
2018,48,Texas,White,96167,87678,186068,169651,113206,72862,101574,68077,.60841197,.59872323,,,0,0
2018,49,Utah,Asian,1129,928,2105,1705,1453,652,1194,511,.6902613,.70029324,,,0,0
2018,49,Utah,Black,216,173,313,247,127,186,107,140,.40575081,.43319839,,,0,0
2018,49,Utah,Hispanic,3286,2983,4672,4165,2691,1981,2392,1773,.5759846,.57430971,,,0,0
2018,49,Utah,Total,28304,25693,43569,39152,29781,13788,26891,12261,.68353647,.68683594,13564,9589,0,0
2018,49,Utah,White,21941,20044,33916,30741,23930,9986,21779,8962,.7055667,.70846754,,,0,0
2018,50,Vermont,Asian,241,123,512,253,353,159,176,77,.68945313,.69565219,,,0,0
2018,50,Vermont,Black,60,45,101,72,47,54,32,40,.46534654,.44444445,,,0,0
2018,50,Vermont,Hispanic,128,110,238,207,145,93,125,82,.60924369,.60386473,,,0,0
2018,50,Vermont,Total,3739,3174,6431,5383,4235,2196,3526,1857,.65852898,.65502506,2229,1547,0,0
2018,50,Vermont,White,3122,2738,5277,4602,3500,1777,3041,1561,.66325563,.66079962,,,0,0
2018,51,Virginia,Asian,11823,10773,28535,26078,21007,7528,19275,6803,.73618364,.73912877,,,0,0
2018,51,Virginia,Black,7168,6698,12123,11268,4935,7188,4528,6740,.40707746,.40184593,,,0,0
2018,51,Virginia,Hispanic,9208,8571,16515,15243,9335,7180,8534,6709,.56524372,.55986357,,,0,0
2018,51,Virginia,Total,79597,72170,158833,143469,104445,54388,93862,49607,.65757746,.65423191,35834,24251,0,0
2018,51,Virginia,White,44466,39753,88533,78842,60979,27554,54065,24777,.68877143,.68573856,,,0,0
2018,53,Washington,Asian,8893,8191,18166,16881,12811,5355,11857,5024,.70521855,.70238727,,,0,0
2018,53,Washington,Black,1594,1502,2396,2249,778,1618,707,1542,.32470784,.31436193,,,0,0
2018,53,Washington,Hispanic,7347,6803,11075,10214,4917,6158,4362,5852,.44397292,.4270609,,,0,0
2018,53,Washington,Total,54195,49737,93123,85335,58526,34597,53029,32306,.62848061,.62142146,26249,15719,0,0
2018,53,Washington,White,29713,27094,50447,45831,33500,16947,30216,15615,.66406327,.65929174,,,0,0
2018,54,West Virginia,Asian,264,213,575,473,418,157,344,129,.72695655,.72727275,,,1,0
2018,54,West Virginia,Black,136,128,222,205,87,135,77,128,.3918919,.37560976,,,1,0
2018,54,West Virginia,Hispanic,248,230,398,374,183,215,176,198,.45979899,.47058824,,,1,0
2018,54,West Virginia,Total,7970,7403,13110,12183,6032,7078,5600,6583,.46010679,.45965689,4313,1897,1,0
2018,54,West Virginia,White,6817,6359,11141,10406,5016,6125,4694,5712,.45022887,.45108593,,,1,0
2018,55,Wisconsin,Asian,2642,2244,5535,4734,3743,1792,3192,1542,.67624211,.67427123,,,0,0
2018,55,Wisconsin,Black,1323,1158,2032,1756,583,1449,470,1286,.28690946,.26765376,,,0,0
2018,55,Wisconsin,Hispanic,3737,3209,5911,5071,3104,2807,2609,2462,.52512264,.51449418,,,0,0
2018,55,Wisconsin,Total,48066,43871,81735,74413,54542,27193,49536,24877,.66730285,.66569012,22965,15991,0,0
2018,55,Wisconsin,White,37852,34963,64146,59138,44588,19558,41016,18122,.6951018,.69356418,,,0,0
2018,56,Wyoming,Asian,37,37,65,65,38,27,38,27,.58461541,.58461541,,,0,0
2018,56,Wyoming,Black,18,18,25,25,7,18,7,18,.28,.28,,,0,0
2018,56,Wyoming,Hispanic,252,250,351,349,136,215,134,215,.38746437,.38395417,,,0,0
2018,56,Wyoming,Total,2197,2174,3341,3305,1858,1483,1827,1478,.55612093,.55279881,1298,739,0,0
2018,56,Wyoming,White,1771,1751,2733,2700,1595,1138,1567,1133,.58360773,.58037037,,,0,0
2019,1,Alabama,Asian,1433,1265,3515,3131,2321,1194,2030,1101,.66031295,.64835519,,,0,0
2019,1,Alabama,Black,4879,4718,7931,7690,1347,6584,1248,6442,.16983987,.16228868,,,0,0
2019,1,Alabama,Hispanic,2084,1959,3727,3504,1229,2498,1098,2406,.32975584,.31335616,,,0,0
2019,1,Alabama,Total,29472,26719,54462,49575,22428,32034,19332,30243,.41181007,.38995463,15313,6415,0,0
2019,1,Alabama,White,18985,16820,35581,31780,16202,19379,13777,18003,.45535538,.43351164,,,0,0
2019,2,Alaska,Asian,408,404,717,712,332,385,332,380,.46304044,.46629214,,,0,0
2019,2,Alaska,Black,62,60,102,98,41,61,41,57,.40196079,.41836736,,,0,0
2019,2,Alaska,Hispanic,250,245,419,413,246,173,243,170,.58711219,.58837771,,,0,0
2019,2,Alaska,Total,3104,3040,5260,5168,3146,2114,3093,2075,.59809887,.59849072,1820,1118,0,0
2019,2,Alaska,White,1862,1822,3162,3104,2070,1092,2034,1070,.65464896,.65528351,,,0,0
2019,4,Arizona,Asian,4109,3669,9885,8920,7621,2264,6889,2031,.77096611,.77230942,,,0,0
2019,4,Arizona,Black,1121,1045,1836,1705,764,1072,689,1016,.41612199,.40410557,,,0,0
2019,4,Arizona,Hispanic,15187,14203,24184,22494,10720,13464,9651,12843,.44326827,.42904773,,,0,0
2019,4,Arizona,Total,40860,37054,72533,65540,43095,29438,38204,27336,.59414333,.58291119,20253,11912,0,0
2019,4,Arizona,White,17321,15295,31319,27640,20953,10366,18306,9334,.66901881,.662301,,,0,0
2019,5,Arkansas,Asian,1049,979,2565,2422,1551,1014,1464,958,.60467833,.60445911,,,1,1
2019,5,Arkansas,Black,3380,3311,5623,5512,697,4926,675,4837,.12395518,.12246009,,,1,1
2019,5,Arkansas,Hispanic,3734,3660,6247,6133,2047,4200,1995,4138,.32767728,.32528943,,,1,1
2019,5,Arkansas,Total,27724,26643,47899,46167,17790,30109,16835,29332,.3714065,.36465439,13961,5418,1,1
2019,5,Arkansas,White,17464,16654,30108,28838,12361,17747,11614,17224,.41055533,.40273249,,,1,1
2019,6,California,Asian,98339,87689,215471,190959,155630,59841,136664,54295,.72227818,.71567196,,,0,0
2019,6,California,Black,10742,9674,18192,16278,6757,11435,5716,10562,.371427,.35114878,,,0,0
2019,6,California,Hispanic,180888,170038,308643,289107,137448,171195,126030,163077,.44533005,.43592855,,,0,0
2019,6,California,Total,423174,379720,793695,706500,476715,316980,414249,292251,.60062742,.58633971,190247,129291,0,0
2019,6,California,White,102110,85276,193157,159848,137276,55881,112253,47595,.71069646,.70224839,,,0,0
2019,8,Colorado,Asian,3511,3288,7095,6647,4946,2149,4619,2028,.69711065,.69489998,,,0,0
2019,8,Colorado,Black,1509,1457,2281,2204,833,1448,799,1405,.36519071,.36252269,,,0,0
2019,8,Colorado,Hispanic,11757,11361,18598,17921,8345,10253,7866,10055,.44870415,.4389264,,,0,0
2019,8,Colorado,Total,53755,50627,91101,85342,55939,35162,51702,33640,.6140328,.60582131,25060,16304,0,0
2019,8,Colorado,White,33355,31104,57002,52848,38060,18942,34983,17865,.66769588,.66195506,,,0,0
2019,9,Connecticut,Asian,4341,3024,9866,6749,7593,2273,5081,1668,.76961279,.75285226,,,0,0
2019,9,Connecticut,Black,2171,1924,3769,3358,1367,2402,1088,2270,.36269566,.32400239,,,0,0
2019,9,Connecticut,Hispanic,5150,4578,8550,7430,4571,3979,3805,3625,.53461987,.51211303,,,0,0
2019,9,Connecticut,Total,37469,30865,70423,56670,48755,21668,38338,18332,.69231641,.67651314,16628,11650,0,0
2019,9,Connecticut,White,23550,19519,43964,35740,32238,11726,26072,9668,.73328179,.72949076,,,0,0
2019,10,Delaware,Asian,842,606,2055,1503,1475,580,1062,441,.71776158,.70658684,,,0,0
2019,10,Delaware,Black,830,718,1279,1092,433,846,332,760,.33854574,.30402932,,,0,0
2019,10,Delaware,Hispanic,802,691,1241,1046,566,675,434,612,.4560838,.41491395,,,0,0
2019,10,Delaware,Total,7586,5482,13361,9465,7701,5660,4926,4539,.576379,.52044374,3006,1637,0,0
2019,10,Delaware,White,4554,3043,7842,5124,4739,3103,2789,2335,.6043101,.54430133,,,0,0
2019,11,District Of Columbia,Asian,322,165,681,351,452,229,169,182,.66372979,.48148149,,,1,1
2019,11,District Of Columbia,Black,2257,2029,3405,2980,785,2620,550,2430,.23054332,.18456376,,,1,1
2019,11,District Of Columbia,Hispanic,1178,915,2062,1499,1010,1052,550,949,.48981571,.36691126,,,1,1
2019,11,District Of Columbia,Total,6642,4433,12532,7738,7017,5515,3064,4674,.55992657,.39596796,2177,789,1,1
2019,11,District Of Columbia,White,2189,846,5166,2127,4106,1060,1504,623,.79481226,.7070992,,,1,1
2019,12,Florida,Asian,14566,12245,33284,27857,22013,11271,17918,9939,.66136885,.64321357,,,0,1
2019,12,Florida,Black,21716,20418,34458,32204,10669,23789,9577,22627,.3096233,.29738542,,,0,1
2019,12,Florida,Hispanic,80123,68077,137885,115051,75293,62592,60482,54569,.54605651,.52569729,,,0,1
2019,12,Florida,Total,217393,187278,394624,335320,215120,179504,175835,159485,.5451265,.52437967,92984,53543,0,1
2019,12,Florida,White,87261,74334,165520,139673,95492,70028,78079,61594,.57692122,.55901283,,,0,1
2019,13,Georgia,Asian,12209,11196,28810,26430,21816,6994,20050,6380,.75723708,.75860763,,,0,1
2019,13,Georgia,Black,17327,16348,26820,25056,9596,17224,8648,16408,.35779271,.34514686,,,0,1
2019,13,Georgia,Hispanic,12485,11463,21053,19078,11044,10009,9942,9136,.52458084,.52112383,,,0,1
2019,13,Georgia,Total,96311,84248,175394,151782,108098,67296,92693,59089,.61631525,.61069822,40945,23417,0,1
2019,13,Georgia,White,48204,39790,87976,71667,59256,28720,48455,23212,.67354733,.67611313,,,0,1
2019,15,Hawaii,Asian,4069,2980,6909,4714,3986,2923,2210,2504,.57692862,.46881628,,,0,0
2019,15,Hawaii,Black,88,79,132,118,52,80,42,76,.39393941,.35593221,,,0,0
2019,15,Hawaii,Hispanic,1546,1155,2333,1700,972,1361,572,1128,.41663095,.33647057,,,0,0
2019,15,Hawaii,Total,9887,7009,16022,10773,8683,7339,4738,6035,.54194236,.43980321,4095,1896,0,0
2019,15,Hawaii,White,1051,716,1781,1194,1131,650,671,523,.63503647,.56197655,,,0,0
2019,16,Idaho,Asian,329,307,751,710,516,235,484,226,.6870839,.68169016,,,0,1
2019,16,Idaho,Black,87,86,134,133,53,81,53,80,.39552239,.39849624,,,0,1
2019,16,Idaho,Hispanic,1117,1044,1716,1611,708,1008,658,953,.4125874,.40844196,,,0,1
2019,16,Idaho,Total,8528,8032,13984,13256,8323,5661,7871,5385,.59518021,.59376884,4473,2623,0,1
2019,16,Idaho,White,6451,6077,10545,10001,6598,3947,6251,3750,.6256994,.62503749,,,0,1
2019,17,Illinois,Asian,15229,14181,34063,31888,25588,8475,24063,7825,.75119632,.75460988,,,0,0
2019,17,Illinois,Black,9537,8788,14721,13549,4465,10256,4068,9481,.30330819,.30024356,,,0,0
2019,17,Illinois,Hispanic,33300,31182,55116,51530,25820,29296,23903,27627,.46846652,.4638657,,,0,0
2019,17,Illinois,Total,128748,117759,234674,214823,149588,85086,136681,78142,.63742894,.63624936,56607,38266,0,0
2019,17,Illinois,White,63831,57327,118202,106291,85113,33089,76730,29561,.72006398,.72188616,,,0,0
2019,18,Indiana,Asian,2902,2456,6755,5698,4753,2002,3932,1766,.70362693,.6900667,,,1,1
2019,18,Indiana,Black,2913,2682,4387,4028,1188,3199,1052,2976,.27080008,.26117179,,,1,1
2019,18,Indiana,Hispanic,4994,4649,7987,7358,3065,4922,2722,4636,.38374859,.36993748,,,1,1
2019,18,Indiana,Total,52065,46846,88555,78975,46295,42260,40167,38808,.52278244,.50860399,26007,13576,1,1
2019,18,Indiana,White,38202,34295,64385,57374,34797,29588,30287,27087,.54045194,.52788723,,,1,1
2019,19,Iowa,Asian,1050,968,2081,1907,1364,717,1254,653,.6554541,.65757734,,,0,0
2019,19,Iowa,Black,465,459,645,639,196,449,193,446,.30387598,.30203444,,,0,0
2019,19,Iowa,Hispanic,1272,1237,1908,1859,814,1094,785,1074,.42662475,.42227003,,,0,0
2019,19,Iowa,Total,13658,12873,21111,19911,12745,8366,11996,7915,.60371369,.60248107,7003,4344,0,0
2019,19,Iowa,White,10009,9376,15190,14261,9644,5546,9059,5202,.63489139,.63522893,,,0,0
2019,20,Kansas,Asian,1179,1081,2365,2195,1733,632,1620,575,.73276955,.73804098,,,0,0
2019,20,Kansas,Black,267,258,385,371,162,223,159,212,.42077923,.42857143,,,0,0
2019,20,Kansas,Hispanic,1021,912,1486,1343,793,693,715,628,.53364736,.53239018,,,0,0
2019,20,Kansas,Total,10147,9097,16378,14694,10815,5563,9735,4959,.66033703,.66251528,5397,3500,0,0
2019,20,Kansas,White,7004,6219,11052,9767,7437,3615,6598,3169,.67290986,.67554009,,,0,0
2019,21,Kentucky,Asian,1674,1461,3615,3148,2483,1132,2139,1009,.68686032,.67947906,,,0,1
2019,21,Kentucky,Black,1695,1652,2431,2345,735,1696,679,1666,.30234471,.28955224,,,0,1
2019,21,Kentucky,Hispanic,1938,1819,3003,2780,1263,1740,1114,1666,.42057943,.40071943,,,0,1
2019,21,Kentucky,Total,33849,30479,54791,48544,28969,25822,24572,23972,.52871823,.50617999,14807,7707,0,1
2019,21,Kentucky,White,26157,23310,42169,36962,22875,19294,19191,17771,.54246008,.51920891,,,0,1
2019,22,Louisiana,Asian,1319,1145,2602,2253,1672,930,1442,811,.64258265,.64003551,,,1,0
2019,22,Louisiana,Black,5742,5472,7584,7160,1364,6220,1174,5986,.17985232,.16396648,,,1,0
2019,22,Louisiana,Hispanic,2013,1694,2962,2394,1206,1756,857,1537,.40715733,.35797828,,,1,0
2019,22,Louisiana,Total,25295,21011,37544,30301,15819,21725,11191,19110,.42134562,.36932775,11114,3722,1,0
2019,22,Louisiana,White,14305,10953,21778,16159,10729,11049,7035,9124,.49265313,.43536109,,,1,0
2019,23,Maine,Asian,654,225,1433,455,840,593,279,176,.58618283,.61318684,,,0,0
2019,23,Maine,Black,145,118,230,191,70,160,55,136,.30434781,.28795812,,,0,0
2019,23,Maine,Hispanic,267,179,462,300,234,228,152,148,.50649351,.50666666,,,0,0
2019,23,Maine,Total,8640,6780,15056,11492,8597,6459,6528,4964,.57100159,.56804734,4628,2847,0,0
2019,23,Maine,White,7082,5904,12126,9966,7034,5092,5735,4231,.58007586,.57545656,,,0,0
2019,24,Maryland,Asian,9529,8656,21884,19899,16769,5115,15275,4624,.7662676,.76762652,,,0,0
2019,24,Maryland,Black,10362,9171,16332,14436,7007,9325,6179,8257,.42903504,.42802715,,,0,0
2019,24,Maryland,Hispanic,7930,7177,13377,12050,7526,5851,6650,5400,.56260747,.55186725,,,0,0
2019,24,Maryland,Total,66428,57169,123872,106577,83140,40732,71187,35390,.67117667,.6679396,26421,17725,0,0
2019,24,Maryland,White,33007,27214,61994,51058,44735,17259,36763,14295,.72160208,.72002429,,,0,0
2019,25,Massachusetts,Asian,8741,6662,19682,14808,15394,4288,11522,3286,.78213596,.77809292,,,0,0
2019,25,Massachusetts,Black,3739,3277,6237,5438,2392,3845,1925,3513,.38351771,.35399044,,,0,0
2019,25,Massachusetts,Hispanic,7702,6863,12904,11424,6653,6251,5619,5805,.51557654,.49185926,,,0,0
2019,25,Massachusetts,Total,66820,56104,125437,103936,86196,39241,70002,33934,.68716568,.67351061,31146,21993,0,0
2019,25,Massachusetts,White,42446,35767,78947,65828,56395,22552,46544,19284,.71433997,.70705473,,,0,0
2019,26,Michigan,Asian,6025,5264,13213,11556,10140,3073,8823,2733,.76742601,.7634995,,,0,0
2019,26,Michigan,Black,3302,2862,4890,4214,1541,3349,1283,2931,.31513292,.30446133,,,0,0
2019,26,Michigan,Hispanic,4290,3711,6863,5936,3586,3277,3089,2847,.52251202,.52038407,,,0,0
2019,26,Michigan,Total,65327,57491,110149,96611,70939,39210,62032,34579,.64402765,.64208007,32107,20869,0,0
2019,26,Michigan,White,48052,42435,78957,69450,51722,27235,45387,24063,.65506542,.65352052,,,0,0
2019,27,Minnesota,Asian,4490,3894,8586,7351,5889,2697,4986,2365,.685884,.67827505,,,0,0
2019,27,Minnesota,Black,2148,1961,3078,2784,1266,1812,1117,1667,.41130605,.40122128,,,0,0
2019,27,Minnesota,Hispanic,2947,2510,4380,3645,2207,2173,1804,1841,.50388128,.49492455,,,0,0
2019,27,Minnesota,Total,45656,40459,74291,65036,49139,25152,42974,22062,.66143948,.6607725,20380,13531,0,0
2019,27,Minnesota,White,32596,29002,52762,46465,36151,16611,31953,14512,.68517113,.68767887,,,0,0
2019,28,Mississippi,Asian,463,392,859,693,530,329,398,295,.61699653,.57431459,,,0,0
2019,28,Mississippi,Black,3015,2917,4437,4265,575,3862,495,3770,.12959206,.11606096,,,0,0
2019,28,Mississippi,Hispanic,566,512,853,769,310,543,267,502,.3634232,.34720415,,,0,0
2019,28,Mississippi,Total,10562,9352,15882,13804,5844,10038,4704,9100,.36796373,.34077078,5801,1883,0,0
2019,28,Mississippi,White,5828,4892,8760,7190,4115,4645,3274,3916,.46974885,.45535466,,,0,0
2019,29,Missouri,Asian,2015,1620,4606,3654,3534,1072,2793,861,.76726007,.76436782,,,0,0
2019,29,Missouri,Black,2475,2171,3571,3089,1000,2571,809,2280,.28003362,.26189706,,,0,0
2019,29,Missouri,Hispanic,1900,1608,2927,2418,1436,1491,1096,1322,.49060473,.45326716,,,0,0
2019,29,Missouri,Total,28380,23221,47277,38047,29955,17322,23438,14609,.6336062,.61602753,12782,7594,0,0
2019,29,Missouri,White,19945,16042,32885,26080,22107,10778,17184,8896,.67225176,.65889573,,,0,0
2019,30,Montana,Asian,67,58,111,93,80,31,69,24,.72072071,.74193549,,,0,0
2019,30,Montana,Black,6,6,6,6,3,3,3,3,.5,.5,,,0,0
2019,30,Montana,Hispanic,167,155,273,252,148,125,139,113,.54212457,.55158728,,,0,0
2019,30,Montana,Total,3698,3468,5706,5358,3734,1972,3504,1854,.65439886,.65397537,1927,1301,0,0
2019,30,Montana,White,3171,2985,4920,4638,3287,1633,3089,1549,.66808945,.66601986,,,0,0
2019,31,Nebraska,Asian,701,596,1395,1175,892,503,732,443,.63942653,.62297875,,,0,0
2019,31,Nebraska,Black,287,261,468,430,177,291,152,278,.37820512,.35348839,,,0,0
2019,31,Nebraska,Hispanic,1216,1172,1922,1855,752,1170,712,1143,.3912591,.38382751,,,0,0
2019,31,Nebraska,Total,9251,8384,15506,14062,8879,6627,7868,6194,.57261705,.55952209,4186,2593,0,0
2019,31,Nebraska,White,6461,5814,10761,9707,6572,4189,5821,3886,.61072391,.59967035,,,0,0
2019,32,Nevada,Asian,2983,2732,6354,5801,3889,2465,3477,2324,.61205542,.59937942,,,0,0
2019,32,Nevada,Black,857,806,1373,1272,520,853,455,817,.37873271,.3577044,,,0,0
2019,32,Nevada,Hispanic,8272,7910,13422,12754,5325,8097,4941,7813,.39673671,.38740787,,,0,0
2019,32,Nevada,Total,22324,20523,39223,35630,20222,19001,17932,17698,.51556486,.50328374,10874,6216,0,0
2019,32,Nevada,White,7854,6949,13966,12128,8402,5564,7234,4894,.60160387,.59647095,,,0,0
2019,33,New Hampshire,Asian,856,460,1844,951,1398,446,723,228,.75813448,.76025236,,,0,0
2019,33,New Hampshire,Black,93,50,154,83,83,71,41,42,.53896105,.49397591,,,0,0
2019,33,New Hampshire,Hispanic,340,240,559,375,350,209,232,143,.62611806,.61866665,,,0,0
2019,33,New Hampshire,Total,7646,5947,12697,9479,8822,3875,6633,2846,.69480979,.69975734,3684,2619,0,0
2019,33,New Hampshire,White,5874,4830,9373,7494,6482,2891,5257,2237,.69156086,.70149451,,,0,0
2019,34,New Jersey,Asian,16922,14858,39796,35125,32019,7777,28374,6751,.80457836,.80780071,,,0,0
2019,34,New Jersey,Black,4891,4032,8223,6765,3234,4989,2716,4049,.39328712,.4014782,,,0,0
2019,34,New Jersey,Hispanic,15444,13513,25949,22674,13261,12688,11629,11045,.51104087,.51287818,,,0,0
2019,34,New Jersey,Total,80788,68792,159398,136032,110245,49153,94816,41216,.69163352,.69701248,38252,27801,0,0
2019,34,New Jersey,White,38661,32211,75708,63099,54635,21073,45957,17142,.72165424,.72833169,,,0,0
2019,35,New Mexico,Asian,400,352,828,747,499,329,432,315,.60265702,.57831323,,,0,0
2019,35,New Mexico,Black,111,105,171,159,52,119,41,118,.30409357,.25786164,,,0,0
2019,35,New Mexico,Hispanic,6367,6146,9780,9440,3052,6728,2835,6605,.31206545,.30031779,,,0,0
2019,35,New Mexico,Total,10881,10313,17430,16515,6831,10599,6175,10340,.39191049,.3739025,6310,2663,0,0
2019,35,New Mexico,White,3027,2793,5215,4820,2810,2405,2497,2323,.53883028,.51804978,,,0,0
2019,36,New York,Asian,29386,27034,58939,54045,41265,17674,37893,16152,.70013064,.70113796,,,0,0
2019,36,New York,Black,17946,16472,28687,26426,9041,19646,8040,18386,.31516019,.30424583,,,0,0
2019,36,New York,Hispanic,37384,33913,59801,54165,28059,31742,24957,29208,.46920621,.46075881,,,0,0
2019,36,New York,Total,179974,158523,319337,281218,195800,123537,171387,109831,.61314535,.60944533,79809,51378,0,0
2019,36,New York,White,83430,70571,151823,128743,105077,46746,89659,39084,.69210202,.69641846,,,0,0
2019,37,North Carolina,Asian,6808,6163,16358,14742,11613,4745,10332,4410,.70992786,.70085472,,,0,1
2019,37,North Carolina,Black,8478,8127,13302,12681,4080,9222,3705,8976,.30672079,.29216939,,,0,1
2019,37,North Carolina,Hispanic,9449,8985,15954,14913,6966,8988,6238,8675,.43663031,.41829276,,,0,1
2019,37,North Carolina,Total,82148,74341,152602,135948,86098,66504,74033,61915,.56419969,.54456854,38079,21523,0,1
2019,37,North Carolina,White,51348,45427,96268,83784,57741,38527,48704,35080,.59979433,.58130431,,,0,1
2019,38,North Dakota,Asian,115,105,240,215,168,72,162,53,.69999999,.75348836,,,0,1
2019,38,North Dakota,Black,92,86,144,138,53,91,53,85,.36805555,.38405797,,,0,1
2019,38,North Dakota,Hispanic,126,116,199,184,110,89,102,82,.55276382,.55434781,,,0,1
2019,38,North Dakota,Total,3274,2937,5053,4603,2846,2207,2625,1978,.56322974,.57028025,1596,928,0,1
2019,38,North Dakota,White,2744,2454,4158,3779,2359,1799,2164,1615,.56734008,.57263827,,,0,1
2019,39,Ohio,Asian,5154,4220,12207,10089,9664,2543,7990,2099,.79167688,.79195166,,,0,0
2019,39,Ohio,Black,4926,4224,7371,6169,2485,4886,2034,4135,.33713201,.32971308,,,0,0
2019,39,Ohio,Hispanic,3595,2987,5848,4796,3318,2530,2635,2161,.56737345,.54941618,,,0,0
2019,39,Ohio,Total,72745,60578,128221,106695,84019,44202,69394,37301,.65526706,.65039599,33215,20729,0,0
2019,39,Ohio,White,54576,45245,95178,79074,63927,31251,52817,26257,.67165732,.66794395,,,0,0
2019,40,Oklahoma,Asian,1392,1283,3082,2874,1784,1298,1628,1246,.5788449,.56645793,,,0,0
2019,40,Oklahoma,Black,1045,1019,1609,1562,338,1271,310,1252,.21006836,.19846351,,,0,0
2019,40,Oklahoma,Hispanic,2912,2776,4643,4410,1630,3013,1485,2925,.35106611,.33673468,,,0,0
2019,40,Oklahoma,Total,18025,16537,30559,27895,14577,15982,12736,15159,.47701168,.45656928,9760,4752,0,0
2019,40,Oklahoma,White,9279,8254,15799,13980,8531,7268,7246,6734,.53997087,.51831186,,,0,0
2019,41,Oregon,Asian,2336,1940,4449,3746,2984,1465,2429,1317,.67071253,.64842498,,,0,0
2019,41,Oregon,Black,306,263,464,402,186,278,160,242,.40086207,.39800996,,,0,0
2019,41,Oregon,Hispanic,3767,3596,5639,5364,2478,3161,2313,3051,.43943962,.43120804,,,0,0
2019,41,Oregon,Total,21557,19613,35521,32272,21386,14135,18928,13344,.6020664,.58651465,10609,6662,0,0
2019,41,Oregon,White,13114,11961,21654,19748,13805,7849,12333,7415,.63752657,.62451893,,,0,0
2019,42,Pennsylvania,Asian,8644,6971,19334,15732,14832,4502,12130,3602,.76714593,.7710399,,,0,0
2019,42,Pennsylvania,Black,4127,3406,6189,5132,2013,4176,1667,3465,.32525447,.32482463,,,0,0
2019,42,Pennsylvania,Hispanic,5476,4642,9077,7693,4836,4241,4087,3606,.53277516,.53126216,,,0,0
2019,42,Pennsylvania,Total,77481,65363,138647,117005,94036,44611,80047,36958,.67824042,.68413317,36994,24801,0,0
2019,42,Pennsylvania,White,55007,46744,96633,82125,67377,29256,57880,24245,.69724625,.70477933,,,0,0
2019,44,Rhode Island,Asian,600,355,1284,735,876,408,464,271,.68224299,.63129252,,,0,0
2019,44,Rhode Island,Black,414,386,685,637,142,543,122,515,.20729928,.19152276,,,0,0
2019,44,Rhode Island,Hispanic,1389,1284,2343,2123,816,1527,663,1460,.34827146,.31229392,,,0,0
2019,44,Rhode Island,Total,8159,6581,14896,11584,8375,6521,6085,5499,.56223148,.52529353,3684,2036,0,0
2019,44,Rhode Island,White,5210,4120,9638,7372,5997,3641,4458,2914,.62222451,.60472059,,,0,0
2019,45,South Carolina,Asian,1777,1612,3715,3371,2637,1078,2399,972,.70982504,.71165824,,,1,1
2019,45,South Carolina,Black,3972,3872,5830,5670,1946,3884,1884,3786,.33379075,.33227512,,,1,1
2019,45,South Carolina,Hispanic,3103,2974,4906,4668,2547,2359,2395,2273,.51916021,.51306772,,,1,1
2019,45,South Carolina,Total,34952,32494,57895,53166,34324,23571,31101,22065,.59286642,.58497912,15330,9027,1,1
2019,45,South Carolina,White,23866,21913,39825,36040,25191,14634,22562,13478,.63254237,.62602663,,,1,1
2019,46,South Dakota,Asian,130,111,271,240,199,72,175,65,.73431736,.72916669,,,0,0
2019,46,South Dakota,Black,79,71,140,130,75,65,71,59,.53571427,.54615384,,,0,0
2019,46,South Dakota,Hispanic,132,120,230,213,134,96,121,92,.5826087,.56807512,,,0,0
2019,46,South Dakota,Total,2932,2623,4895,4437,3340,1555,3027,1410,.68232888,.68221772,1512,1018,0,0
2019,46,South Dakota,White,2387,2153,3942,3593,2766,1176,2514,1079,.70167428,.69969386,,,0,0
2019,47,Tennessee,Asian,2635,2121,6187,4969,4355,1832,3402,1567,.70389527,.68464482,,,0,1
2019,47,Tennessee,Black,4413,4113,6615,6100,1886,4729,1567,4533,.28510961,.25688526,,,0,1
2019,47,Tennessee,Hispanic,3587,3225,5841,5165,2653,3188,2173,2992,.45420304,.42071635,,,0,1
2019,47,Tennessee,Total,40161,33941,68620,56490,38765,29855,29671,26819,.56492275,.5252434,16458,8771,0,1
2019,47,Tennessee,White,26932,22184,45744,36597,27692,18052,20773,15824,.60536903,.56761485,,,0,1
2019,48,Texas,Asian,37211,35471,89820,85828,63709,26111,60701,25127,.70929635,.70724005,,,0,0
2019,48,Texas,Black,22361,21748,36574,35455,10321,26253,9733,25722,.282195,.274517,,,0,0
2019,48,Texas,Hispanic,152574,148286,258167,250172,89968,168199,85544,164628,.34848762,.34194073,,,0,0
2019,48,Texas,Total,325088,309095,598008,566539,292337,305671,271261,295278,.48885131,.47880375,142128,75844,0,0
2019,48,Texas,White,95982,87440,183001,166255,112014,70987,100086,66169,.612095,.60200292,,,0,0
2019,49,Utah,Asian,1218,1026,2201,1826,1500,701,1261,565,.68150842,.69058049,,,0,0
2019,49,Utah,Black,215,172,321,259,130,191,113,146,.40498441,.43629342,,,0,0
2019,49,Utah,Hispanic,3564,3249,5101,4588,2921,2180,2621,1967,.57263279,.57127291,,,0,0
2019,49,Utah,Total,29679,27165,45542,41283,30676,14866,27830,13453,.67357606,.67412734,13903,9714,0,0
2019,49,Utah,White,22776,20976,35136,32097,24389,10747,22272,9825,.69413137,.69389665,,,0,0
2019,50,Vermont,Asian,235,133,553,276,387,166,193,83,.69981915,.69927537,,,0,0
2019,50,Vermont,Black,60,45,109,81,45,64,39,42,.41284403,.48148149,,,0,0
2019,50,Vermont,Hispanic,121,101,208,171,136,72,113,58,.65384614,.6608187,,,0,0
2019,50,Vermont,Total,3800,3263,6555,5500,4361,2194,3660,1840,.66529369,.66545457,2148,1535,0,0
2019,50,Vermont,White,3177,2816,5349,4702,3593,1756,3156,1546,.67171437,.67120373,,,0,0
2019,51,Virginia,Asian,12301,11230,29741,27147,21952,7789,20069,7078,.73810565,.7392714,,,0,0
2019,51,Virginia,Black,7393,6870,12370,11461,5012,7358,4626,6835,.40517381,.40362969,,,0,0
2019,51,Virginia,Hispanic,9172,8511,16500,15145,9251,7249,8432,6713,.56066668,.55675143,,,0,0
2019,51,Virginia,Total,79554,72089,159084,143398,103871,55213,93270,50128,.65293181,.65042746,35357,24492,0,0
2019,51,Virginia,White,43882,39201,87347,77660,59461,27886,52747,24913,.68074459,.67920423,,,0,0
2019,53,Washington,Asian,9552,8811,19688,18334,14126,5562,13118,5216,.71749288,.71550125,,,0,0
2019,53,Washington,Black,1520,1430,2333,2193,815,1518,736,1457,.34933561,.33561331,,,0,0
2019,53,Washington,Hispanic,7009,6567,10382,9655,4534,5848,4055,5600,.43671739,.41998965,,,0,0
2019,53,Washington,Total,53517,49254,92346,84892,58529,33817,53160,31732,.63380116,.62620741,25935,16088,0,0
2019,53,Washington,White,28953,26460,48990,44641,32554,16436,29375,15266,.66450298,.65802735,,,0,0
2019,54,West Virginia,Asian,269,220,624,520,425,199,356,164,.68108976,.68461537,,,1,0
2019,54,West Virginia,Black,136,131,200,192,89,111,84,108,.44499999,.4375,,,1,0
2019,54,West Virginia,Hispanic,235,221,367,341,179,188,162,179,.48773843,.47507331,,,1,0
2019,54,West Virginia,Total,8054,7557,12895,12087,5808,7087,5365,6722,.45040715,.4438653,4303,2009,1,0
2019,54,West Virginia,White,6968,6574,11040,10424,4851,6189,4518,5906,.43940216,.43342286,,,1,0
2019,55,Wisconsin,Asian,2700,2287,5495,4696,3776,1719,3240,1456,.68717015,.68994892,,,0,0
2019,55,Wisconsin,Black,1200,1035,1781,1541,545,1236,448,1093,.30600786,.29072031,,,0,0
2019,55,Wisconsin,Hispanic,4031,3395,6267,5305,3162,3105,2668,2637,.50454766,.50292176,,,0,0
2019,55,Wisconsin,Total,47624,43356,79817,72892,53039,26778,48469,24423,.66450757,.66494268,22980,15911,0,0
2019,55,Wisconsin,White,37114,34293,62026,57496,42887,19139,39730,17766,.69143587,.69100457,,,0,0
2019,56,Wyoming,Asian,45,45,83,83,57,26,57,26,.68674701,.68674701,,,0,0
2019,56,Wyoming,Black,16,16,22,22,7,15,7,15,.31818181,.31818181,,,0,0
2019,56,Wyoming,Hispanic,289,284,387,381,178,209,174,207,.45994833,.4566929,,,0,0
2019,56,Wyoming,Total,2242,2224,3387,3367,1856,1531,1843,1524,.54797757,.54737157,1332,721,0,0
2019,56,Wyoming,White,1739,1726,2673,2659,1510,1163,1501,1158,.56490833,.56449795,,,0,0
2000,1,Alabama,Total,,,,,,,,,,,2750,1510,0,0
2000,2,Alaska,Total,,,,,,,,,,,1028,677,0,0
2000,4,Arizona,Total,,,,,,,,,,,4378,2805,0,0
2000,5,Arkansas,Total,,,,,,,,,,,2208,1166,0,0
2000,6,California,Total,,,,,,,,,,,68648,46495,0,0
2000,8,Colorado,Total,,,,,,,,,,,7256,4762,0,0
2000,9,Connecticut,Total,,,,,,,,,,,5665,4034,0,0
2000,10,Delaware,Total,,,,,,,,,,,824,467,0,0
2000,11,District Of Columbia,Total,,,,,,,,,,,467,179,0,0
2000,12,Florida,Total,,,,,,,,,,,23288,13885,0,0
2000,13,Georgia,Total,,,,,,,,,,,11169,6263,0,0
2000,15,Hawaii,Total,,,,,,,,,,,1108,605,0,0
2000,16,Idaho,Total,,,,,,,,,,,1559,1052,0,0
2000,17,Illinois,Total,,,,,,,,,,,15035,11038,0,0
2000,18,Indiana,Total,,,,,,,,,,,7064,3553,0,0
2000,19,Iowa,Total,,,,,,,,,,,2324,1663,0,0
2000,20,Kansas,Total,,,,,,,,,,,2026,1278,0,0
2000,21,Kentucky,Total,,,,,,,,,,,3920,2027,0,0
2000,22,Louisiana,Total,,,,,,,,,,,1214,711,0,0
2000,23,Maine,Total,,,,,,,,,,,1809,1235,0,0
2000,24,Maryland,Total,,,,,,,,,,,9781,6811,0,0
2000,25,Massachusetts,Total,,,,,,,,,,,10399,7680,0,0
2000,26,Michigan,Total,,,,,,,,,,,12808,8113,0,0
2000,27,Minnesota,Total,,,,,,,,,,,7712,4620,0,0
2000,28,Mississippi,Total,,,,,,,,,,,1361,567,0,0
2000,29,Missouri,Total,,,,,,,,,,,2869,1937,0,0
2000,30,Montana,Total,,,,,,,,,,,1102,736,0,0
2000,31,Nebraska,Total,,,,,,,,,,,986,632,0,0
2000,32,Nevada,Total,,,,,,,,,,,1961,1184,0,0
2000,33,New Hampshire,Total,,,,,,,,,,,1579,1089,0,0
2000,34,New Jersey,Total,,,,,,,,,,,13357,9631,0,0
2000,35,New Mexico,Total,,,,,,,,,,,2033,1125,0,0
2000,36,New York,Total,,,,,,,,,,,39130,25669,0,0
2000,37,North Carolina,Total,,,,,,,,,,,12170,6960,0,0
2000,38,North Dakota,Total,,,,,,,,,,,505,376,0,0
2000,39,Ohio,Total,,,,,,,,,,,12273,7704,0,0
2000,40,Oklahoma,Total,,,,,,,,,,,3561,2037,0,0
2000,41,Oregon,Total,,,,,,,,,,,3164,2129,0,0
2000,42,Pennsylvania,Total,,,,,,,,,,,14115,9429,0,0
2000,44,Rhode Island,Total,,,,,,,,,,,905,588,0,0
2000,45,South Carolina,Total,,,,,,,,,,,6016,3381,1,1
2000,46,South Dakota,Total,,,,,,,,,,,886,540,0,0
2000,47,Tennessee,Total,,,,,,,,,,,4656,2790,0,0
2000,48,Texas,Total,,,,,,,,,,,35427,21015,0,0
2000,49,Utah,Total,,,,,,,,,,,8024,5701,0,0
2000,50,Vermont,Total,,,,,,,,,,,1076,744,0,0
2000,51,Virginia,Total,,,,,,,,,,,16145,10254,0,0
2000,53,Washington,Total,,,,,,,,,,,6790,4499,0,0
2000,54,West Virginia,Total,,,,,,,,,,,1641,894,0,0
2000,55,Wisconsin,Total,,,,,,,,,,,8907,6172,0,0
2000,56,Wyoming,Total,,,,,,,,,,,396,246,0,0
